que	kʷɛ	kw~E	o
não	nɐ̃w̃	na*w*	o
de	dɛ	dE	n
um	ũ	u*	o
para	pɐɾɐ	para	n
eu	ew	ew	n
se	sɛ	sE	n
me	mɛ	mE	n
uma	umɐ	uma	n
está	ɛʃta	ESta	o
com	kõ	ko*	o
do	do	do	n
por	poɾ	por	o
te	tɛ	tE	n
os	oʃ	oS	n
bem	bɛ̃	bE*	o
em	ɛ̃	E*	n
ele	ɛlɛ	ElE	o
isso	iʃso	iSso	o
mas	mɐʃ	maS	n
da	dɐ	da	n
como	komo	komo	o
no	no	no	n
sim	sĩ	si*	o
as	ɐʃ	aS	n
mais	majʃ	mayS	o
na	nɐ	na	n
meu	mew	mew	o
você	voze	voze	o
aqui	ɐkʷi	akw~i	o
muito	mujto	muyto	o
foi	fowi	fowi	o
estou	ɛʃtowu	EStowu	o
vamos	vɐmoʃ	vamoS	o
ela	ɛlɐ	Ela	n
fazer	fɐzɛɾ	fazEr	o
vai	vaj	vay	o
isto	iʃto	iSto	o
já	ʒa	Za	o
tem	tɛ̃	tE*	o
só	sɔ	so	o
minha	minɐ	mina	o
nos	noʃ	noS	n
ser	sɛɾ	sEr	o
tudo	tudo	tudo	o
ao	ɐo	ao	o
tenho	tɛno	tEno	o
vou	vowu	vowu	o
sei	sɛj	sEy	o
agora	ɐɡoɾɐ	agora	n
há	a	a	o
lá	la	la	o
tu	tu	tu	o
quando	kɐndo	kando	o
porque	poɾkʷɛ	porkw~E	o
estás	ɛʃtaʃ	EStaS	o
quem	kʷɛ̃	kw~E*	o
onde	ondɛ	ondE	o
nada	nɐdɐ	nada	n
ter	tɛɾ	tEr	o
então	ɛntɐ̃w̃	Enta*w*	o
dizer	dizɛɾ	dizEr	o
lhe	lɛ	lE	o
seu	sew	sew	o
era	ɛɾɐ	Era	n
sou	sowu	sowu	n
ou	owu	owu	o
coisa	kowizɐ	kowiza	o
quero	kʷɛɾo	kw~Ero	o
são	sɐ̃w̃	sa*w*	o
sua	suɐ	sua	o
pode	podɛ	podE	o
nós	nɔʃ	noS	o
mesmo	mɛʃmo	mESmo	o
ver	vɛɾ	vEr	s
disse	diʃsɛ	diSsE	o
eles	ɛlɛʃ	ElES	o
bom	bõ	bo*	o
estava	ɛʃtɐvɐ	EStava	o
esta	ɛʃtɐ	ESta	o
todos	todoʃ	todoS	o
mim	mĩ	mi*	o
posso	poʃso	poSso	o
dos	doʃ	doS	n
lo	lo	lo	o
estão	ɛʃtɐ̃w̃	ESta*w*	o
temos	tɛmoʃ	tEmoS	o
nunca	nunkɐ	nunka	o
este	ɛʃtɛ	EStE	o
casa	kɐzɐ	kaza	o
até	ɐte	ate	o
assim	ɐʃsĩ	aSsi*	o
acho	ɐko	ako	o
quer	kʷɛɾ	kw~Er	o
tens	tɛnʃ	tEnS	n
tempo	tɛmpo	tEmpo	n
ir	iɾ	ir	n
falar	fɐlɐɾ	falar	o
quê	kʷe	kw~e	o
ainda	ajndɐ	aynda	o
tua	tuɐ	tua	o
teu	tew	tew	o
favor	fɐvoɾ	favor	n
pai	paj	pay	o
também	tɐmbẽ	tambe*	o
obrigado	obʁiɡɐdo	obXigado	o
vez	vɛʒ	vEZ	o
deus	dewʃ	dewS	o
certo	sɛɾto	sErto	o
tão	tɐ̃w̃	ta*w*	o
sobre	sobʁɛ	sobXE	o
melhor	mɛloɾ	mElor	o
noite	nowitɛ	nowitE	o
és	eʃ	eS	o
dia	diɐ	dia	n
estamos	ɛʃtɐmoʃ	EStamoS	o
talvez	tɐlvɛʒ	talvEZ	o
nem	nɛ̃	nE*	o
depois	dɛpowiʃ	dEpowiS	o
sempre	sɛmpɾɛ	sEmprE	o
sabe	sɐbɛ	sabE	o
mãe	mɐ̃j̃	ma*y*	o
vida	vidɐ	vida	o
sem	sɛ̃	sE*	o
alguém	ɐlɡʷẽ	algw~e*	o
olá	ola	ola	o
anos	ɐnoʃ	anoS	n
sabes	sɐbɛʃ	sabES	o
ti	ti	ti	n
homem	omɛ̃	omE*	o
dele	dɛlɛ	dElE	o
alguma	ɐlɡmɐ	algma	o
das	dɐʃ	daS	n
algo	ɐlɡo	algo	o
parece	pɐɾɛzɛ	parEzE	o
sr	sɾ	sr	n
tinha	tinɐ	tina	o
senhor	sɛnoɾ	sEnor	n
boa	bowɐ	bowa	n
vais	vajʃ	vayS	o
coisas	kowizɐʃ	kowizaS	o
estar	ɛʃtɐɾ	EStar	o
faz	fɐʒ	faZ	o
queres	kʷɛɾɛʃ	kw~ErES	o
vocês	vozeʃ	vozeS	o
dois	dowiʃ	dowiS	n
ficar	fikɐɾ	fikar	o
pelo	pɛlo	pElo	o
preciso	pɾɛziso	prEziso	o
aí	aj́	ay	o
diz	diʒ	diZ	o
claro	klɐɾo	klaro	n
pessoas	pɛʃsowɐʃ	pESsowaS	o
essa	ɛʃsɐ	ESsa	o
verdade	vɛɾdɐdɛ	vErdadE	o
dar	dɐɾ	dar	o
esse	ɛʃsɛ	ESsE	o
antes	ɐntɛʃ	antES	n
ninguém	ninɡʷẽ	ningw~e*	o
tipo	tipo	tipo	o
la	lɐ	la	n
vão	vɐ̃w̃	va*w*	o
trabalho	tɾɐbɐlo	trabalo	o
oh	o	o	n
grande	ɡɾɐndɛ	grandE	o
comigo	komiɡo	komigo	o
outra	owutʁɐ	owutXa	o
apenas	ɐpɛnɐʃ	apEnaS	o
espera	ɛʃpɛɾɐ	ESpEra	o
saber	sɐbɛɾ	sabEr	n
vá	va	va	o
podes	podɛʃ	podES	v
pouco	powuko	powuko	o
dinheiro	dinɛjɾo	dinEyro	o
qual	kɐl	kal	o
qualquer	kɐlkʷɛɾ	kalkw~Er	o
pois	powiʃ	powiS	n
podemos	podɛmoʃ	podEmoS	o
fora	foɾɐ	fora	n
pela	pɛlɐ	pEla	o
merda	mɛɾdɐ	mErda	o
deve	dɛvɛ	dEvE	o
daqui	dɐkʷi	dakw~i	o
olha	olɐ	ola	o
cá	ka	ka	o
filho	filo	filo	o
disso	diʃso	diSso	o
toda	todɐ	toda	n
hoje	oʒɛ	oZE	o
mulher	mulɛɾ	mulEr	o
meus	mewʃ	mewS	o
todo	todo	todo	o
nome	nomɛ	nomE	n
seja	sɛʒɐ	sEZa	o
num	nũ	nu*	o
desculpa	dɛʃkulpɐ	dESkulpa	o
outro	owutʁo	owutXo	o
nosso	noʃso	noSso	o
nossa	noʃsɐ	noSsa	o
sair	sajɾ	sayr	o
queria	kʷɛɾiɐ	kw~Eria	o
sério	seɾio	serio	o
dá	da	da	o
mundo	mundo	mundo	o
quanto	kɐnto	kanto	o
seus	sewʃ	sewS	o
certeza	sɛɾtɛzɐ	sErtEza	o
mal	mɐl	mal	o
dela	dɛlɐ	dEla	o
têm	tẽ	te*	o
amigo	ɐmiɡo	amigo	n
volta	voltɐ	volta	n
às	aʃ	aS	o
carro	kɐʁo	kaXo	o
três	tɾeʃ	treS	o
passa	pɐʃsɐ	paSsa	o
embora	ɛmboɾɐ	Embora	o
fez	fɛʒ	fEZ	n
novo	novo	novo	o
aconteceu	ɐkontɛzew	akontEzew	o
deixa	dɛjksɐ	dEyksa	o
problema	pɾoblɛmɐ	problEma	o
menos	mɛnoʃ	mEnoS	o
vem	vɛ̃	vE*	o
nas	nɐʃ	naS	n
lugar	luɡɐɾ	lugar	o
consigo	konsiɡo	konsigo	o
será	sɛɾa	sEra	o
dentro	dɛntɾo	dEntro	o
pensar	pɛnsɐɾ	pEnsar	o
ok	ok	ok	n
vezes	vɛzɛʃ	vEzES	o
lado	lɐdo	lado	o
primeiro	pɾimɛjɾo	primEyro	o
contigo	kontiɡo	kontigo	o
numa	numɐ	numa	o
todas	todɐʃ	todaS	n
tentar	tɛntɐɾ	tEntar	o
vi	vi	vi	n
aos	ɐoʃ	aoS	o
parte	pɐɾtɛ	partE	o
cara	kɐɾɐ	kara	o
ei	ɛj	Ey	o
ali	ɐli	ali	n
voltar	voltɐɾ	voltar	o
algum	ɐlɡ̃	alg*	o
hora	oɾɐ	ora	o
porquê	poɾkʷe	porkw~e	o
anda	ɐndɐ	anda	o
desculpe	dɛʃkulpɛ	dESkulpE	o
vê	ve	ve	o
ajudar	ɐʒudɐɾ	aZudar	o
aquele	ɐkʷɛlɛ	akw~ElE	o
obrigada	obʁiɡɐdɐ	obXigada	o
querida	kʷɛɾidɐ	kw~Erida	o
sinto	sinto	sinto	o
pensei	pɛnsɛj	pEnsEy	o
los	loʃ	loS	o
homens	omɛnʃ	omEnS	o
duas	duɐʃ	duaS	o
dias	diɐʃ	diaS	n
sabia	sɐbiɐ	sabia	o
fui	fuj	fuy	o
matar	mɐtɐɾ	matar	o
gente	ʒɛntɛ	ZEntE	o
uns	unʃ	unS	n
gosto	ɡoʃto	goSto	o
razão	ʁɐzɐ̃w̃	Xaza*w*	o
vos	voʃ	voS	o
atrás	ɐtʁaʃ	atXaS	o
deixar	dɛjksɐɾ	dEyksar	o
cabeça	kɐbɛsɐ	kabEsa	o
podem	podɛ̃	podE*	o
amor	ɐmoɾ	amor	n
fica	fikɐ	fika	n
achas	ɐkɐʃ	akaS	o
somos	somoʃ	somoS	o
pronto	pɾonto	pronto	r
família	fɐmiliɐ	familia	o
horas	oɾɐʃ	oraS	o
entre	ɛntɾɛ	EntrE	o
ajuda	ɐʒudɐ	aZuda	o
frente	fɾɛntɛ	frEntE	o
tal	tɐl	tal	o
polícia	poliziɐ	polizia	o
ideia	idɛjɐ	idEya	o
tarde	tɐɾdɛ	tardE	o
suas	suɐʃ	suaS	o
porta	poɾtɐ	porta	n
passar	pɐʃsɐɾ	paSsar	o
tenha	tɛnɐ	tEna	o
amigos	ɐmiɡoʃ	amigoS	n
ouvir	owuviɾ	owuvir	o
precisa	pɾɛzisɐ	prEzisa	o
fiz	fiʒ	fiZ	o
encontrar	ɛnkontɾɐɾ	Enkontrar	o
deles	dɛlɛʃ	dElES	o
ia	iɐ	ia	n
nenhum	nɛnũ	nEnu*	o
momento	momɛnto	momEnto	o
devia	dɛviɐ	dEvia	o
acha	ɐkɐ	aka	o
aquilo	ɐkʷilo	akw~ilo	o
cidade	sidɐdɛ	sidadE	o
cima	simɐ	sima	o
minutos	minutoʃ	minutoS	o
desde	dɛʃdɛ	dESdE	o
foram	foɾɐ̃	fora*	n
si	si	si	n
pessoa	pɛʃsowɐ	pESsowa	o
entrar	ɛntɾɐɾ	Entrar	o
pra	pɾɐ	pra	o
diga	diɡɐ	diga	o
morrer	moʁɛɾ	moXEr	o
nova	novɐ	nova	n
podia	podiɐ	podia	n
seria	sɛɾiɐ	sEria	o
caso	kɐzo	kazo	o
chegar	kɛɡɐɾ	kEgar	o
outros	owutʁoʃ	owutXoS	o
tanto	tɐnto	tanto	o
morto	moɾto	morto	o
levar	lɛvɐɾ	lEvar	o
amanhã	ɐmɐnɐ̃	amana*	o
forma	foɾmɐ	forma	o
quase	kɐzɛ	kazE	o
fosse	foʃsɛ	foSsE	n
medo	mɛdo	mEdo	o
lhes	lɛʃ	lES	o
história	iʃtɔɾiɐ	iStoria	o
conta	kontɐ	konta	o
óptimo	ɔptimo	optimo	o
contra	kontɾɐ	kontra	n
irmão	iɾmɐ̃w̃	irma*w*	o
sido	sido	sido	o
minhas	minɐʃ	minaS	o
aquela	ɐkʷɛlɐ	akw~Ela	o
arma	ɐɾmɐ	arma	o
caminho	kɐmino	kamino	o
morte	moɾtɛ	mortE	o
sorte	soɾtɛ	sortE	o
enquanto	ɛnkɐnto	Enkanto	o
vir	viɾ	vir	o
cuidado	kujdɐdo	kuydado	o
primeira	pɾimɛjɾɐ	primEyra	o
cada	kɐdɐ	kada	o
deixe	dɛjksɛ	dEyksE	o
semana	sɛmɐnɐ	sEmana	o
feliz	fɛliʒ	fEliZ	o
trabalhar	tɾɐbɐlɐɾ	trabalar	o
precisamos	pɾɛzisɐmoʃ	prEzisamoS	o
alguns	ɐlɡnʃ	algnS	o
espero	ɛʃpɛɾo	ESpEro	o
maneira	mɐnɛjɾɐ	manEyra	o
tive	tivɛ	tivE	o
olhos	oloʃ	oloS	o
faço	fɐso	faso	o
ano	ɐno	ano	n
vejo	vɛʒo	vEZo	o
rapaz	ʁɐpɐʒ	XapaZ	o
fala	fɐlɐ	fala	o
durante	duɾɐntɛ	durantE	n
acabou	ɐkɐbowu	akabowu	o
desta	dɛʃtɐ	dESta	o
pessoal	pɛʃsowɐl	pESsowal	o
pára	paɾɐ	para	o
quarto	kɐɾto	karto	n
estes	ɛʃtɛʃ	EStES	o
feito	fɛjto	fEyto	o
neste	nɛʃtɛ	nEStE	o
for	foɾ	for	o
mãos	mɐ̃w̃ʃ	ma*w*S	o
sangue	sɐnɡʷɛ	sangw~E	o
fim	fĩ	fi*	o
acontecer	ɐkontɛzɛɾ	akontEzEr	o
dr	dɾ	dr	o
ouve	owuvɛ	owuvE	o
faça	fɐsɐ	fasa	o
estas	ɛʃtɐʃ	EStaS	o
adeus	ɐdewʃ	adewS	o
querem	kʷɛɾɛ̃	kw~ErE*	o
causa	kawzɐ	kawza	n
meio	mɛjo	mEyo	o
filha	filɐ	fila	o
água	aɡɐ	aga	o
juntos	ʒuntoʃ	ZuntoS	n
lamento	lɐmɛnto	lamEnto	o
perto	pɛɾto	pErto	o
teus	tewʃ	tewS	o
jogo	ʒoɡo	Zogo	o
cinco	sinko	sinko	o
umas	umɐʃ	umaS	n
importante	impoɾtɐntɛ	importantE	o
última	ultimɐ	ultima	o
logo	loɡo	logo	n
manhã	mɐnɐ̃	mana*	o
chefe	kɛfɛ	kEfE	o
senhora	sɛnoɾɐ	sEnora	o
acredito	ɐkʁɛdito	akXEdito	o
nossos	noʃsoʃ	noSsoS	o
calma	kɐlmɐ	kalma	o
poder	podɛɾ	podEr	o
única	unikɐ	unika	o
querido	kʷɛɾido	kw~Erido	o
ouvi	owuvi	owuvi	o
deu	dew	dew	o
terra	tɛʁɐ	tEXa	o
disto	diʃto	diSto	o
guerra	ɡʷɛʁɐ	gw~EXa	o
rápido	ʁapido	Xapido	o
algumas	ɐlɡmɐʃ	algmaS	o
realmente	ʁɛɐlmɛntɛ	XEalmEntE	o
poderia	podɛɾiɐ	podEria	o
digo	diɡo	digo	o
contar	kontɐɾ	kontar	o
amo	ɐmo	amo	o
mão	mɐ̃w̃	ma*w*	o
nisso	niʃso	niSso	o
baixo	bajkso	baykso	o
difícil	difizil	difizil	o
começar	komɛsɐɾ	komEsar	o
viu	viw	viw	o
comer	komɛɾ	komEr	n
ah	ɐ	a	o
espere	ɛʃpɛɾɛ	ESpErE	o
mesma	mɛʃmɐ	mESma	o
deste	dɛʃtɛ	dEStE	o
problemas	pɾoblɛmɐʃ	problEmaS	o
capitão	kɐpitɐ̃w̃	kapita*w*	o
corpo	koɾpo	korpo	o
dólares	dɔlɐɾɛʃ	dolarES	o
importa	impoɾtɐ	importa	o
número	numɛɾo	numEro	o
usar	uzɐɾ	uzar	o
disseste	diʃsɛʃtɛ	diSsEStE	o
maior	mɐjoɾ	mayor	o
segundo	sɛɡndo	sEgndo	o
significa	siɡnifikɐ	signifika	o
escola	ɛʃkolɐ	ESkola	o
sabem	sɐbɛ̃	sabE*	o
parar	pɐɾɐɾ	parar	o
dormir	doɾmiɾ	dormir	o
andar	ɐndɐɾ	andar	o
quatro	kɐtʁo	katXo	o
segurança	sɛɡʁɐnsɐ	sEgXansa	o
coração	koɾɐsɐ̃w̃	korasa*w*	o
raio	ʁɐjo	Xayo	o
havia	ɐviɐ	avia	o
sai	saj	say	o
teve	tɛvɛ	tEvE	o
buscar	buʃkɐɾ	buSkar	o
presidente	pɾɛzidɛntɛ	prEzidEntE	o
nenhuma	nɛnumɐ	nEnuma	o
agente	ɐʒɛntɛ	aZEntE	o
chega	kɛɡɐ	kEga	o
rapazes	ʁɐpɐzɛʃ	XapazES	o
pequeno	pɛkʷɛno	pEkw~Eno	o
idiota	idiotɐ	idiota	o
fizeste	fizɛʃtɛ	fizEStE	o
tirar	tiɾɐɾ	tirar	o
morreu	moʁew	moXew	o
força	foɾsɐ	forsa	o
sabemos	sɐbɛmoʃ	sabEmoS	o
ontem	ontɛ̃	ontE*	o
prazer	pɾɐzɛɾ	prazEr	o
procura	pɾokuɾɐ	prokura	o
viver	vivɛɾ	vivEr	o
mau	maw	maw	o
estado	ɛʃtɐdo	EStado	o
sentir	sɛntiɾ	sEntir	o
meses	mɛzɛʃ	mEzES	n
chama	kɐmɐ	kama	o
festa	fɛʃtɐ	fESta	o
mulheres	mulɛɾɛʃ	mulErES	o
pedir	pɛdiɾ	pEdir	o
conheço	konɛso	konEso	o
crianças	kɾiɐnsɐʃ	kriansaS	o
devo	dɛvo	dEvo	o
rapariga	ʁɐpɐɾiɡɐ	Xapariga	o
perder	pɛɾdɛɾ	pErdEr	o
sra	sɾɐ	sra	o
pergunta	pɛɾɡntɐ	pErgnta	o
marido	mɐɾido	marido	o
eram	ɛɾɐ̃	Era*	o
fazes	fɐzɛʃ	fazES	v
altura	ɐltuɾɐ	altura	o
porra	poʁɐ	poXa	o
olhe	olɛ	olE	o
olhar	olɐɾ	olar	o
velho	vɛlo	vElo	o
muitas	mujtɐʃ	muytaS	o
mil	mil	mil	n
filhos	filoʃ	filoS	o
näo	nɐ̈o	nao	o
trás	tɾaʃ	traS	o
fazendo	fɐzɛndo	fazEndo	o
muitos	mujtoʃ	muytoS	o
equipa	ɛkʷipɐ	Ekw~ipa	o
pais	pajʃ	payS	o
telefone	tɛlɛfonɛ	tElEfonE	o
acabar	ɐkɐbɐɾ	akabar	o
dê	de	de	o
teria	tɛɾiɐ	tEria	o
possível	poʃsivɛl	poSsivEl	o
depressa	dɛpʁɛʃsɐ	dEpXESsa	o
elas	ɛlɐʃ	ElaS	n
venha	vɛnɐ	vEna	o
esperar	ɛʃpɛɾɐɾ	ESpErar	o
muita	mujtɐ	muyta	o
tomar	tomɐɾ	tomar	o
pena	pɛnɐ	pEna	o
gosta	ɡoʃtɐ	goSta	o
armas	ɐɾmɐʃ	armaS	o
nesta	nɛʃtɐ	nESta	o
vivo	vivo	vivo	o
vindo	vindo	vindo	o
tivesse	tivɛʃsɛ	tivESsE	o
longe	lonʒɛ	lonZE	o
penso	pɛnso	pEnso	o
acordo	ɐkoɾdo	akordo	o
demais	dɛmajʃ	dEmayS	o
vossa	voʃsɐ	voSsa	o
pensa	pɛnsɐ	pEnsa	o
errado	ɛʁɐdo	EXado	o
conseguir	konsɛɡʷiɾ	konsEgw~ir	o
gostaria	ɡoʃtɐɾiɐ	goStaria	o
estranho	ɛʃtɾɐno	EStrano	o
veio	vɛjo	vEyo	o
fácil	fazil	fazil	o
sente	sɛntɛ	sEntE	n
essas	ɛʃsɐʃ	ESsaS	o
brincar	bɾinkɐɾ	brinkar	o
licença	lizɛnsɐ	lizEnsa	o
suficiente	sufiziɛntɛ	sufiziEntE	o
seis	sɛjʃ	sEyS	o
mudar	mudɐɾ	mudar	o
passado	pɐʃsɐdo	paSsado	n
estavam	ɛʃtɐvɐ̃	EStava*	o
plano	plɐno	plano	n
fogo	foɡo	fogo	o
livro	livʁo	livXo	o
esses	ɛʃsɛʃ	ESsES	n
irmã	iɾmɐ̃	irma*	o
dizem	dizɛ̃	dizE*	o
falta	fɐltɐ	falta	o
fazem	fɐzɛ̃	fazE*	o
jantar	ʒɐntɐɾ	Zantar	o
rei	ʁɛj	XEy	o
devias	dɛviɐʃ	dEviaS	o
matou	mɐtowu	matowu	o
cama	kɐmɐ	kama	o
leva	lɛvɐ	lEva	n
nossas	noʃsɐʃ	noSsaS	o
foste	foʃtɛ	foStE	o
sozinho	sozino	sozino	o
adoro	ɐdoɾo	adoro	o
exactamente	ɛzɐktɐmɛntɛ	EzaktamEntE	o
paz	pɐʒ	paZ	o
tuas	tuɐʃ	tuaS	o
além	ɐlẽ	ale*	o
pôr	poɾ	por	o
palavra	pɐlɐvʁɐ	palavXa	o
sala	sɐlɐ	sala	o
consegue	konsɛɡʷɛ	konsEgw~E	o
pagar	pɐɡɐɾ	pagar	o
seguir	sɛɡʷiɾ	sEgw~ir	o
possa	poʃsɐ	poSsa	o
atenção	ɐtɛnsɐ̃w̃	atEnsa*w*	o
fique	fikʷɛ	fikw~E	o
passou	pɐʃsowu	paSsowu	o
comida	komidɐ	komida	o
ar	ɐɾ	ar	n
culpa	kulpɐ	kulpa	o
pelos	pɛloʃ	pEloS	o
ficou	fikowu	fikowu	o
ligar	liɡɐɾ	ligar	o
bastante	bɐʃtɐntɛ	baStantE	o
continua	kontinuɐ	kontinua	n
correr	koʁɛɾ	koXEr	o
estavas	ɛʃtɐvɐʃ	EStavaS	o
precisas	pɾɛzisɐʃ	prEzisaS	o
boca	bokɐ	boka	o
luz	luʒ	luZ	o
outras	owutʁɐʃ	owutXaS	o
único	uniko	uniko	o
menina	mɛninɐ	mEnina	o
deixou	dɛjksowu	dEyksowu	o
casamento	kɐzɐmɛnto	kazamEnto	o
acreditar	ɐkʁɛditɐɾ	akXEditar	o
médico	mediko	mediko	o
próprio	pɾɔpʁio	propXio	o
semanas	sɛmɐnɐʃ	sEmanaS	o
chegou	kɛɡowu	kEgowu	o
fico	fiko	fiko	o
minuto	minuto	minuto	o
especial	ɛʃpɛziɐl	ESpEzial	s
chamar	kɐmɐɾ	kamar	o
lembro	lɛmbɾo	lEmbro	o
forte	foɾtɛ	fortE	n
esteja	ɛʃtɛʒɐ	EStEZa	o
perguntar	pɛɾɡntɐɾ	pErgntar	o
mostrar	moʃtɾɐɾ	moStrar	o
filme	filmɛ	filmE	o
sequer	sɛkʷɛɾ	sEkw~Er	o
provavelmente	pɾovɐvɛlmɛntɛ	provavElmEntE	o
país	paj́ʃ	payS	o
cala	kɐlɐ	kala	o
houve	owuvɛ	owuvE	o
pé	pe	pe	o
partir	pɐɾtiɾ	partir	o
fazê	fɐze	faze	o
diferente	difɛɾɛntɛ	difErEntE	o
pior	pioɾ	pior	o
rua	ʁuɐ	Xua	o
deveria	dɛvɛɾiɐ	dEvEria	o
próxima	pɾɔksimɐ	proksima	o
café	kɐfe	kafe	o
direito	diɾɛjto	dirEyto	o
existe	ɛziʃtɛ	EziStE	o
boas	bowɐʃ	bowaS	n
resto	ʁɛʃto	XESto	o
quiser	kʷizɛɾ	kw~izEr	o
pare	pɐɾɛ	parE	v
toma	tomɐ	toma	o
quis	kʷiʃ	kw~iS	o
viste	viʃtɛ	viStE	o
lembra	lɛmbɾɐ	lEmbra	o
hospital	oʃpitɐl	oSpital	n
estive	ɛʃtivɛ	EStivE	o
arranjar	ɐʁɐnʒɐɾ	aXanZar	o
portanto	poɾtɐnto	portanto	o
continuar	kontinuɐɾ	kontinuar	o
descobrir	dɛʃkobʁiɾ	dESkobXir	o
conhece	konɛzɛ	konEzE	o
bebé	bɛbe	bEbe	o
sam	sɐ̃	sa*	n
sexo	sɛkso	sEkso	o
manter	mɐntɛɾ	mantEr	o
visto	viʃto	viSto	o
las	lɐʃ	laS	n
jogar	ʒoɡɐɾ	Zogar	o
vim	vĩ	vi*	n
encontrei	ɛnkontɾɛj	EnkontrEy	o
demasiado	dɛmɐziɐdo	dEmaziado	o
vosso	voʃso	voSso	o
ai	aj	ay	n
raios	ʁɐjoʃ	XayoS	o
ponto	ponto	ponto	o
sentido	sɛntido	sEntido	o
dez	dɛʒ	dEZ	o
milhões	milʃ	milS	o
puta	putɐ	puta	o
sinal	sinɐl	sinal	o
aqueles	ɐkʷɛlɛʃ	akw~ElES	o
ganhar	ɡɐnɐɾ	ganar	o
haver	ɐvɛɾ	avEr	o
querer	kʷɛɾɛɾ	kw~ErEr	o
consegues	konsɛɡʷɛʃ	konsEgw~ES	o
devem	dɛvɛ̃	dEvE*	o
seguro	sɛɡʁo	sEgXo	o
criança	kɾiɐnsɐ	kriansa	o
último	ultimo	ultimo	o
sistema	siʃtɛmɐ	siStEma	o
gostava	ɡoʃtɐvɐ	goStava	o
prisão	pɾizɐ̃w̃	priza*w*	o
cão	kɐ̃w̃	ka*w*	o
queremos	kʷɛɾɛmoʃ	kw~ErEmoS	o
linda	lindɐ	linda	o
esposa	ɛʃpozɐ	ESpoza	o
local	lokɐl	lokal	n
peço	pɛso	pEso	o
música	muzikɐ	muzika	o
acontece	ɐkontɛzɛ	akontEzE	o
sítio	sitio	sitio	o
irá	iɾa	ira	o
trouxe	tɾowuksɛ	trowuksE	o
esteve	ɛʃtɛvɛ	EStEvE	o
pequena	pɛkʷɛnɐ	pEkw~Ena	o
conhecer	konɛzɛɾ	konEzEr	o
precisar	pɾɛzisɐɾ	prEzisar	o
salvar	sɐlvɐɾ	salvar	o
oportunidade	opoɾtunidɐdɛ	oportunidadE	o
fazemos	fɐzɛmoʃ	fazEmoS	o
mr	mɾ	mr	n
encontro	ɛnkontɾo	Enkontro	o
capaz	kɐpɐʒ	kapaZ	o
comprar	kompɾɐɾ	komprar	o
avião	ɐviɐ̃w̃	avia*w*	o
achei	ɐkɛj	akEy	o
vês	veʃ	veS	o
chão	kɐ̃w̃	ka*w*	o
natal	nɐtɐl	natal	n
jesus	ʒɛzuʃ	ZEzuS	n
mortos	moɾtoʃ	mortoS	o
jovem	ʒovɛ̃	ZovE*	o
negócio	nɛɡɔzio	nEgozio	o
banho	bɐno	bano	o
beber	bɛbɛɾ	bEbEr	o
grandes	ɡɾɐndɛʃ	grandES	o
livre	livʁɛ	livXE	o
alto	ɐlto	alto	n
situação	situɐsɐ̃w̃	situasa*w*	o
miúdo	miẃdo	miwdo	o
sob	sob	sob	n
connosco	konnoʃko	konnoSko	o
tratar	tɾɐtɐɾ	tratar	o
nao	nɐo	nao	o
deves	dɛvɛʃ	dEvES	o
cedo	sɛdo	sEdo	o
veja	vɛʒɐ	vEZa	o
apanhar	ɐpɐnɐɾ	apanar	o
entra	ɛntɾɐ	Entra	o
futuro	futuɾo	futuro	o
próximo	pɾɔksimo	proksimo	o
entendo	ɛntɛndo	EntEndo	o
nave	nɐvɛ	navE	n
final	finɐl	final	n
vontade	vontɐdɛ	vontadE	o
cabelo	kɐbɛlo	kabElo	o
certa	sɛɾtɐ	sErta	o
general	ʒɛnɛɾɐl	ZEnEral	n
perfeito	pɛɾfɛjto	pErfEyto	o
dou	dowu	dowu	o
lembras	lɛmbɾɐʃ	lEmbraS	o
respeito	ʁɛʃpɛjto	XESpEyto	o
devemos	dɛvɛmoʃ	dEvEmoS	o
nisto	niʃto	niSto	o
lindo	lindo	lindo	o
bonito	bonito	bonito	n
guarda	ɡɐɾdɐ	garda	o
ordem	oɾdɛ̃	ordE*	o
miúda	miẃdɐ	miwda	o
disseram	diʃsɛɾɐ̃	diSsEra*	o
preocupes	pɾɛokupɛʃ	prEokupES	o
perguntas	pɛɾɡntɐʃ	pErgntaS	o
interessa	intɛɾɛʃsɐ	intErESsa	o
oi	owi	owi	o
põe	p	p	o
questão	kʷɛʃtɐ̃w̃	kw~ESta*w*	o
mensagem	mɛnsɐʒɛ̃	mEnsaZE*	o
palavras	pɐlɐvʁɐʃ	palavXaS	o
começou	komɛsowu	komEsowu	o
senhores	sɛnoɾɛʃ	sEnorES	o
falando	fɐlɐndo	falando	o
gajo	ɡɐʒo	gaZo	o
notícias	notiziɐʃ	notiziaS	o
acabei	ɐkɐbɛj	akabEy	o
estiver	ɛʃtivɛɾ	EStivEr	o
estávamos	ɛʃtavɐmoʃ	EStavamoS	o
louco	lowuko	lowuko	o
tira	tiɾɐ	tira	o
vista	viʃtɐ	viSta	n
campo	kɐmpo	kampo	o
linha	linɐ	lina	o
tinhas	tinɐʃ	tinaS	o
mesa	mɛzɐ	mEza	n
finalmente	finɐlmɛntɛ	finalmEntE	o
própria	pɾɔpʁiɐ	propXia	o
assassino	ɐʃsɐʃsino	aSsaSsino	o
droga	dɾoɡɐ	droga	o
fizeram	fizɛɾɐ̃	fizEra*	o
emprego	ɛmpɾɛɡo	EmprEgo	o
amiga	ɐmiɡɐ	amiga	o
barco	bɐɾko	barko	o
conversa	konvɛɾsɐ	konvErsa	o
terá	tɛɾa	tEra	o
faria	fɐɾiɐ	faria	o
simples	simplɛʃ	simplES	n
missão	miʃsɐ̃w̃	miSsa*w*	o
viagem	viɐʒɛ̃	viaZE*	o
tom	tõ	to*	n
ataque	ɐtɐkʷɛ	atakw~E	o
consegui	konsɛɡʷi	konsEgw~i	o
nessa	nɛʃsɐ	nESsa	o
gostas	ɡoʃtɐʃ	goStaS	o
bonita	bonitɐ	bonita	o
grupo	ɡɾupo	grupo	o
real	ʁɛɐl	XEal	n
completamente	komplɛtɐmɛntɛ	komplEtamEntE	o
doente	dowɛntɛ	dowEntE	o
bocado	bokɐdo	bokado	o
abrir	ɐbʁiɾ	abXir	o
dessa	dɛʃsɐ	dESsa	o
ler	lɛɾ	lEr	n
tio	tio	tio	o
pelas	pɛlɐʃ	pElaS	o
doutor	dowutoɾ	dowutor	o
lista	liʃtɐ	liSta	o
crime	kɾimɛ	krimE	n
novamente	novɐmɛntɛ	novamEntE	o
procurar	pɾokuɾɐɾ	prokurar	o
chamada	kɐmɐdɐ	kamada	o
segunda	sɛɡndɐ	sEgnda	o
acredita	ɐkʁɛditɐ	akXEdita	o
quiseres	kʷizɛɾɛʃ	kw~izErES	o
daí	daj́	day	o
normal	noɾmɐl	normal	n
relação	ʁɛlɐsɐ̃w̃	XElasa*w*	o
modo	modo	modo	o
resposta	ʁɛʃpoʃtɐ	XESpoSta	o
sol	sol	sol	n
desse	dɛʃsɛ	dESsE	o
viva	vivɐ	viva	n
lutar	lutɐɾ	lutar	o
aonde	ɐondɛ	aondE	o
tipos	tipoʃ	tipoS	o
dizes	dizɛʃ	dizES	o
saia	sɐjɐ	saya	o
estúpido	ɛʃtupido	EStupido	o
meia	mɛjɐ	mEya	o
assunto	ɐʃsunto	aSsunto	o
deixem	dɛjksɛ̃	dEyksE*	o
melhores	mɛloɾɛʃ	mElorES	o
escritório	ɛʃkɾitɔɾio	ESkritorio	o
serviço	sɛɾviso	sErviso	o
facto	fɐkto	fakto	o
dor	doɾ	dor	o
casar	kɐzɐɾ	kazar	o
David	dɐvid	david	n
dito	dito	dito	o
exército	ɛzeɾsito	Ezersito	o
fundo	fundo	fundo	o
fugir	fuʒiɾ	fuZir	o
acidente	ɐzidɛntɛ	azidEntE	o
faças	fɐsɐʃ	fasaS	o
segundos	sɛɡndoʃ	sEgndoS	o
nesse	nɛʃsɛ	nESsE	o
vale	vɐlɛ	valE	n
fixe	fiksɛ	fiksE	o
george	ʒɛoɾʒɛ	ZEorZE	n
sonho	sono	sono	o
nele	nɛlɛ	nElE	o
quantos	kɐntoʃ	kantoS	o
escuta	ɛʃkutɐ	ESkuta	o
ambos	ɐmboʃ	amboS	n
graças	ɡɾɐsɐʃ	grasaS	o
papá	pɐpa	papa	o
preso	pɾɛzo	prEzo	o
tinham	tinɐ̃	tina*	o
professor	pɾofɛʃsoɾ	profESsor	n
trazer	tɾɐzɛɾ	trazEr	o
ajudá	ɐʒuda	aZuda	o
dei	dɛj	dEy	o
pensas	pɛnsɐʃ	pEnsaS	o
fiquei	fikʷɛj	fikw~Ey	o
sete	sɛtɛ	sEtE	o
esperem	ɛʃpɛɾɛ̃	ESpErE*	o
roupa	ʁowupɐ	Xowupa	o
hotel	otɛl	otEl	n
verdadeiro	vɛɾdɐdɛjɾo	vErdadEyro	o
devíamos	dɛviɐmoʃ	dEviamoS	o
fantástico	fɐntaʃtiko	fantaStiko	o
creio	kɾɛjo	krEyo	o
espaço	ɛʃpɐso	ESpaso	o
idade	idɐdɛ	idadE	o
bons	bonʃ	bonS	o
tocar	tokɐɾ	tokar	o
olho	olo	olo	o
companhia	kompɐniɐ	kompania	o
saiu	sɐju	sayu	o
conseguiu	konsɛɡʷiw	konsEgw~iw	o
jeito	ʒɛjto	ZEyto	o
pensava	pɛnsɐvɐ	pEnsava	o
escolha	ɛʃkolɐ	ESkola	o
levou	lɛvowu	lEvowu	o
iria	iɾiɐ	iria	o
mente	mɛntɛ	mEntE	o
estivesse	ɛʃtivɛʃsɛ	EStivESsE	o
caixa	kajksɐ	kayksa	o
ouça	owusɐ	owusa	o
sozinha	sozinɐ	sozina	o
tiro	tiɾo	tiro	n
programa	pɾoɡʁɐmɐ	progXama	o
esquerda	ɛʃkʷɛɾdɐ	ESkw~Erda	o
breve	bɾɛvɛ	brEvE	n
parabéns	pɐɾɐbenʃ	parabenS	o
voz	voʒ	voZ	o
chave	kɐvɛ	kavE	o
gostar	ɡoʃtɐɾ	goStar	o
engraçado	ɛnɡɾɐsɐdo	Engrasado	o
diabo	diɐbo	diabo	o
costas	koʃtɐʃ	koStaS	n
informação	infoɾmɐsɐ̃w̃	informasa*w*	o
olhem	olɛ̃	olE*	o
pegar	pɛɡɐɾ	pEgar	o
erro	ɛʁo	EXo	o
falou	fɐlowu	falowu	o
namorada	nɐmoɾɐdɐ	namorada	o
fome	fomɛ	fomE	o
cabo	kɐbo	kabo	o
abre	ɐbʁɛ	abXE	o
volto	volto	volto	o
incrível	inkɾivɛl	inkrivEl	o
banco	bɐnko	banko	o
fazia	fɐziɐ	fazia	o
estrada	ɛʃtɾɐdɐ	EStrada	o
após	ɐpɔʃ	apoS	o
posição	pozisɐ̃w̃	pozisa*w*	o
excelente	ɛsɛlɛntɛ	EsElEntE	o
juro	ʒuɾo	Zuro	o
má	ma	ma	o
parem	pɐɾɛ̃	parE*	o
morta	moɾtɐ	morta	o
loja	loʒɐ	loZa	o
coronel	koɾonɛl	koronEl	o
prometo	pɾomɛto	promEto	o
povo	povo	povo	o
presente	pɾɛzɛntɛ	prEzEntE	o
tempos	tɛmpoʃ	tEmpoS	n
fomos	fomoʃ	fomoS	o
carta	kɐɾtɐ	karta	o
mestre	mɛʃtɾɛ	mEStrE	o
proteger	pɾotɛʒɛɾ	protEZEr	o
explicar	ɛsplikɐɾ	Esplikar	o
leve	lɛvɛ	lEvE	o
trata	tɾɐtɐ	trata	o
simplesmente	simplɛʃmɛntɛ	simplESmEntE	o
ora	oɾɐ	ora	n
the	tɛ	tE	o
governo	ɡovɛɾno	govErno	o
mata	mɐtɐ	mata	o
cair	kajɾ	kayr	o
centro	sɛntɾo	sEntro	o
prova	pɾovɐ	prova	o
senhoras	sɛnoɾɐʃ	sEnoraS	o
chamado	kɐmɐdo	kamado	o
céu	sɛw	sEw	o
mês	meʃ	meS	o
aposto	ɐpoʃto	apoSto	o
energia	ɛnɛɾʒiɐ	EnErZia	o
soube	sowubɛ	sowubE	o
mamã	mɐmɐ̃	mama*	o
norte	noɾtɛ	nortE	o
destino	dɛʃtino	dEStino	o
quente	kʷɛntɛ	kw~EntE	o
tradução	tɾɐdusɐ̃w̃	tradusa*w*	o
feira	fɛjɾɐ	fEyra	o
conversar	konvɛɾsɐɾ	konvErsar	o
ordens	oɾdɛnʃ	ordEnS	o
lembrar	lɛmbɾɐɾ	lEmbrar	o
almoço	ɐlmoso	almoso	o
metade	mɛtɐdɛ	mEtadE	o
direita	diɾɛjtɐ	dirEyta	o
mandar	mɐndɐɾ	mandar	o
papel	pɐpɛl	papEl	o
miúdos	miẃdoʃ	miwdoS	o
liga	liɡɐ	liga	o
chamo	kɐmo	kamo	o
pediu	pɛdiw	pEdiw	o
perdi	pɛɾdi	pErdi	o
indo	indo	indo	o
ouviste	owuviʃtɛ	owuviStE	o
diabos	diɐboʃ	diaboS	o
foda	fodɐ	foda	o
advogado	ɐdvoɡɐdo	advogado	o
tornar	toɾnɐɾ	tornar	o
base	bɐzɛ	bazE	n
conseguimos	konsɛɡʷimoʃ	konsEgw~imoS	o
imediatamente	imɛdiɐtɐmɛntɛ	imEdiatamEntE	o
lei	lɛj	lEy	n
através	ɐtʁɐveʃ	atXaveS	o
interessante	intɛɾɛʃsɐntɛ	intErESsantE	o
planeta	plɐnɛtɐ	planEta	o
bolas	bolɐʃ	bolaS	n
cheio	kɛjo	kEyo	o
voltou	voltowu	voltowu	o
esquece	ɛʃkʷɛzɛ	ESkw~EzE	o
saiam	sɐjɐ̃	saya*	o
James	ʒɐmɛʃ	ZamES	n
impossível	impoʃsivɛl	impoSsivEl	o
tenente	tɛnɛntɛ	tEnEntE	o
escrever	ɛʃkɾɛvɛɾ	ESkrEvEr	o
funciona	funsionɐ	funsiona	o
bela	bɛlɐ	bEla	o
entendido	ɛntɛndido	EntEndido	o
pés	peʃ	peS	o
reunião	ʁewniɐ̃w̃	Xewnia*w*	o
luta	lutɐ	luta	n
saída	saj́dɐ	sayda	o
cena	sɛnɐ	sEna	o
inferno	infɛɾno	infErno	n
percebo	pɛɾsɛbo	pErsEbo	o
oito	owito	owito	o
máquina	makʷinɐ	makw~ina	o
comandante	komɐndɐntɛ	komandantE	o
câmara	kamɐɾɐ	kamara	o
falei	fɐlɛj	falEy	o
segredo	sɛɡʁɛdo	sEgXEdo	o
regras	ʁɛɡʁɐʃ	XEgXaS	o
acerca	ɐzɛɾkɐ	azErka	o
odeio	odɛjo	odEyo	o
fizemos	fizɛmoʃ	fizEmoS	o
bomba	bombɐ	bomba	o
precisam	pɾɛzisɐ̃	prEzisa*	o
sargento	sɐɾʒɛnto	sarZEnto	o
passo	pɐʃso	paSso	o
trabalha	tɾɐbɐlɐ	trabala	o
honra	onʁɐ	onXa	o
vidas	vidɐʃ	vidaS	o
digas	diɡɐʃ	digaS	o
preocupe	pɾɛokupɛ	prEokupE	o
bebida	bɛbidɐ	bEbida	o
perceber	pɛɾsɛbɛɾ	pErsEbEr	o
bar	bɐɾ	bar	n
provas	pɾovɐʃ	provaS	o
sul	sul	sul	o
surpresa	suɾpɾɛzɐ	surprEza	o
tentei	tɛntɛj	tEntEy	o
deixei	dɛjksɛj	dEyksEy	o
começa	komɛsɐ	komEsa	o
piada	piɐdɐ	piada	o
bola	bolɐ	bola	n
ótimo	ɔtimo	otimo	o
estará	ɛʃtɐɾa	EStara	o
venham	vɛnɐ̃	vEna*	o
podias	podiɐʃ	podiaS	o
ouviu	owuviw	owuviw	o
tivemos	tivɛmoʃ	tivEmoS	o
acaba	ɐkɐbɐ	akaba	o
encontrou	ɛnkontɾowu	Enkontrowu	o
bater	bɐtɛɾ	batEr	o
divertido	divɛɾtido	divErtido	o
tá	ta	ta	o
pá	pa	pa	o
tenham	tɛnɐ̃	tEna*	o
desculpem	dɛʃkulpɛ̃	dESkulpE*	o
perigo	pɛɾiɡo	pErigo	o
levá	lɛva	lEva	o
falo	fɐlo	falo	o
percebi	pɛɾsɛbi	pErsEbi	o
tenhas	tɛnɐʃ	tEnaS	o
vejam	vɛʒɐ̃	vEZa*	o
namorado	nɐmoɾɐdo	namorado	o
eras	ɛɾɐʃ	EraS	n
passada	pɐʃsɐdɐ	paSsada	o
senta	sɛntɐ	sEnta	o
mentir	mɛntiɾ	mEntir	o
frio	fɾio	frio	o
ama	ɐmɐ	ama	o
vêm	vẽ	ve*	o
abaixo	ɐbajkso	abaykso	o
apartamento	ɐpɐɾtɐmɛnto	apartamEnto	o
decisão	dɛzisɐ̃w̃	dEzisa*w*	o
conheci	konɛzi	konEzi	o
debaixo	dɛbajkso	dEbaykso	o
tiver	tivɛɾ	tivEr	o
alma	ɐlmɐ	alma	o
velha	vɛlɐ	vEla	o
naquela	nɐkʷɛlɐ	nakw~Ela	o
humano	umɐno	umano	o
vestido	vɛʃtido	vEStido	o
parecia	pɐɾɛziɐ	parEzia	o
belo	bɛlo	bElo	o
aprender	ɐpʁɛndɛɾ	apXEndEr	o
controlo	kontɾolo	kontrolo	o
legal	lɛɡɐl	lEgal	a
segura	sɛɡʁɐ	sEgXa	o
conheces	konɛzɛʃ	konEzES	o
área	aɾɛɐ	arEa	o
compreendo	kompɾɛɛndo	komprEEndo	o
teres	tɛɾɛʃ	tErES	n
padre	pɐdʁɛ	padXE	n
matá	mɐta	mata	o
senti	sɛnti	sEnti	n
ajude	ɐʒudɛ	aZudE	o
prontos	pɾontoʃ	prontoS	o
carne	kɐɾnɛ	karnE	o
cérebro	seɾɛbʁo	serEbXo	o
hipótese	ipɔtɛzɛ	ipotEzE	o
receber	ʁɛzɛbɛɾ	XEzEbEr	o
diria	diɾiɐ	diria	o
traz	tɾɐʒ	traZ	o
horrível	oʁivɛl	oXivEl	o
mostra	moʃtɾɐ	moStra	o
tê	te	te	o
negócios	nɛɡɔzioʃ	nEgozioS	o
teste	tɛʃtɛ	tEStE	o
aniversário	ɐnivɛɾsaɾio	anivErsario	o
cerveja	sɛɾvɛʒɐ	sErvEZa	o
sabias	sɐbiɐʃ	sabiaS	o
fale	fɐlɛ	falE	o
ilha	ilɐ	ila	o
quantas	kɐntɐʃ	kantaS	o
código	kɔdiɡo	kodigo	o
larga	lɐɾɡɐ	larga	o
tínhamos	tinɐmoʃ	tinamoS	o
perdeu	pɛɾdew	pErdew	o
dançar	dɐnsɐɾ	dansar	o
delas	dɛlɐʃ	dElaS	o
sendo	sɛndo	sEndo	o
menino	mɛnino	mEnino	o
sentes	sɛntɛʃ	sEntES	n
confiar	konfiɐɾ	konfiar	o
vive	vivɛ	vivE	o
idéia	idejɐ	ideya	o
tenta	tɛntɐ	tEnta	o
liberdade	libɛɾdɐdɛ	libErdadE	o
preparar	pɾɛpɐɾɐɾ	prEparar	o
naquele	nɐkʷɛlɛ	nakw~ElE	o
socorro	sokoʁo	sokoXo	o
branco	bɾɐnko	branko	o
perigoso	pɛɾiɡozo	pErigozo	o
estaria	ɛʃtɐɾiɐ	EStaria	o
fato	fɐto	fato	o
cerca	sɛɾkɐ	sErka	o
contente	kontɛntɛ	kontEntE	o
esquecer	ɛʃkʷɛzɛɾ	ESkw~EzEr	o
metros	mɛtʁoʃ	mEtXoS	n
acaso	ɐkɐzo	akazo	o
pudesse	pudɛʃsɛ	pudESsE	o
pronta	pɾontɐ	pronta	o
usa	uzɐ	uza	n
igreja	iɡʁɛʒɐ	igXEZa	o
parecer	pɐɾɛzɛɾ	parEzEr	o
mar	mɐɾ	mar	n
maldito	mɐldito	maldito	o
animais	ɐnimajʃ	animayS	o
resolver	ʁɛzolvɛɾ	XEzolvEr	o
entender	ɛntɛndɛɾ	EntEndEr	o
sejas	sɛʒɐʃ	sEZaS	o
américa	ɐmeɾikɐ	amerika	o
serão	sɛɾɐ̃w̃	sEra*w*	o
basta	bɐʃtɐ	baSta	o
roubar	ʁowubɐɾ	Xowubar	o
levanta	lɛvɐntɐ	lEvanta	o
pt	pt	pt	n
comando	komɐndo	komando	o
esperança	ɛʃpɛɾɐnsɐ	ESpEransa	o
mandou	mɐndowu	mandowu	o
façam	fɐsɐ̃	fasa*	o
volte	voltɛ	voltE	n
esconder	ɛʃkondɛɾ	ESkondEr	o
cavalo	kɐvɐlo	kavalo	o
vender	vɛndɛɾ	vEndEr	n
triste	tɾiʃtɛ	triStE	o
vítima	vitimɐ	vitima	o
quais	kajʃ	kayS	o
pedi	pɛdi	pEdi	o
alex	ɐlɛs	alEs	o
deixá	dɛjksa	dEyksa	o
destes	dɛʃtɛʃ	dEStES	o
tentando	tɛntɐndo	tEntando	o
diferença	difɛɾɛnsɐ	difErEnsa	o
ex	ɛs	Es	n
janela	ʒɐnɛlɐ	ZanEla	o
acima	ɐzimɐ	azima	o
maioria	mɐjoɾiɐ	mayoria	o
manda	mɐndɐ	manda	n
colocar	kolokɐɾ	kolokar	o
garota	ɡɐɾotɐ	garota	o
conselho	konsɛlo	konsElo	o
últimos	ultimoʃ	ultimoS	o
alvo	ɐlvo	alvo	o
humanos	umɐnoʃ	umanoS	o
acham	ɐkɐ̃	aka*	o
tanta	tɐntɐ	tanta	o
dizendo	dizɛndo	dizEndo	o
diferentes	difɛɾɛntɛʃ	difErEntES	o
achar	ɐkɐɾ	akar	o
super	supɛɾ	supEr	n
vossos	voʃsoʃ	voSsoS	o
desapareceu	dɛzɐpɐɾɛzew	dEzaparEzew	o
entrada	ɛntɾɐdɐ	Entrada	o
estarei	ɛʃtɐɾɛj	EStarEy	o
foder	fodɛɾ	fodEr	o
contacto	kontɐkto	kontakto	o
tentou	tɛntowu	tEntowu	o
ouro	owuɾo	owuro	o
negro	nɛɡʁo	nEgXo	n
motivo	motivo	motivo	o
passei	pɐʃsɛj	paSsEy	o
rainha	ʁajnɐ	Xayna	o
junto	ʒunto	Zunto	n
espécie	ɛʃpeziɛ	ESpeziE	o
clube	klubɛ	klubE	o
aquelas	ɐkʷɛlɐʃ	akw~ElaS	o
rio	ʁio	Xio	n
parecem	pɐɾɛzɛ̃	parEzE*	o
herói	ɛɾõj̃	Ero*y*	o
realidade	ʁɛɐlidɐdɛ	XEalidadE	o
funcionar	funsionɐɾ	funsionar	o
majestade	mɐʒɛʃtɐdɛ	maZEStadE	o
saúde	saẃdɛ	sawdE	o
totalmente	totɐlmɛntɛ	totalmEntE	o
meter	mɛtɛɾ	mEtEr	n
precisava	pɾɛzisɐvɐ	prEzisava	o
braço	bɾɐso	braso	o
zona	zonɐ	zona	n
seguinte	sɛɡʷintɛ	sEgw~intE	o
propósito	pɾopɔzito	propozito	o
loucura	lowukuɾɐ	lowukura	o
azul	ɐzul	azul	o
suposto	supoʃto	supoSto	o
pareces	pɐɾɛzɛʃ	parEzES	o
computador	komputɐdoɾ	komputador	o
sentar	sɛntɐɾ	sEntar	o
graça	ɡɾɐsɐ	grasa	o
experiência	ɛspɛɾiensiɐ	EspEriensia	o
pobre	pobʁɛ	pobXE	o
corre	koʁɛ	koXE	o
público	publiko	publiko	o
farei	fɐɾɛj	farEy	o
monte	montɛ	montE	n
avó	ɐvɔ	avo	o
livros	livʁoʃ	livXoS	o
desejo	dɛzɛʒo	dEzEZo	o
mantém	mɐntẽ	mante*	o
nível	nivɛl	nivEl	o
rádio	ʁadio	Xadio	o
pernas	pɛɾnɐʃ	pErnaS	o
contou	kontowu	kontowu	o
peça	pɛsɐ	pEsa	o
existem	ɛziʃtɛ̃	EziStE*	o
iorque	ioɾkʷɛ	iorkw~E	o
querias	kʷɛɾiɐʃ	kw~EriaS	o
saco	sɐko	sako	o
vermelho	vɛɾmɛlo	vErmElo	o
destruir	dɛʃtɾujɾ	dEStruyr	o
aparecer	ɐpɐɾɛzɛɾ	aparEzEr	o
devagar	dɛvɐɡɐɾ	dEvagar	o
podíamos	podiɐmoʃ	podiamoS	o
empresa	ɛmpɾɛzɐ	EmprEza	o
poderá	podɛɾa	podEra	o
rabo	ʁɐbo	Xabo	o
principal	pɾinsipɐl	prinsipal	n
terrível	tɛʁivɛl	tEXivEl	o
senão	sɛnɐ̃w̃	sEna*w*	o
foto	foto	foto	o
sonhos	sonoʃ	sonoS	o
garoto	ɡɐɾoto	garoto	o
dra	dɾɐ	dra	o
saiba	sajbɐ	sayba	o
carros	kɐʁoʃ	kaXoS	o
contrário	kontɾaɾio	kontrario	o
exemplo	ɛzɛmplo	EzEmplo	o
dúvida	duvidɐ	duvida	o
americano	ɐmɛɾikɐno	amErikano	o
irmãos	iɾmɐ̃w̃ʃ	irma*w*S	o
destas	dɛʃtɐʃ	dEStaS	o
oficial	ofiziɐl	ofizial	o
pele	pɛlɛ	pElE	o
operação	opɛɾɐsɐ̃w̃	opErasa*w*	o
raparigas	ʁɐpɐɾiɡɐʃ	XaparigaS	o
televisão	tɛlɛvizɐ̃w̃	tElEviza*w*	o
cor	koɾ	kor	o
ligação	liɡɐsɐ̃w̃	ligasa*w*	o
subir	subiɾ	subir	o
entrou	ɛntɾowu	Entrowu	o
drogas	dɾoɡɐʃ	drogaS	o
tribunal	tɾibunɐl	tribunal	n
inteligente	intɛliʒɛntɛ	intEliZEntE	o
cartão	kɐɾtɐ̃w̃	karta*w*	o
mudou	mudowu	mudowu	o
irei	iɾɛj	irEy	o
sejam	sɛʒɐ̃	sEZa*	o
cabrão	kɐbʁɐ̃w̃	kabXa*w*	o
lixo	likso	likso	o
duro	duɾo	duro	o
defesa	dɛfɛzɐ	dEfEza	o
percebes	pɛɾsɛbɛʃ	pErsEbES	o
ficas	fikɐʃ	fikaS	n
fiquem	fikʷɛ̃	fikw~E*	o
contas	kontɐʃ	kontaS	o
toca	tokɐ	toka	o
alta	ɐltɐ	alta	o
vós	vɔʃ	voS	o
enorme	ɛnoɾmɛ	EnormE	o
maluco	mɐluko	maluko	o
perdido	pɛɾdido	pErdido	o
afinal	ɐfinɐl	afinal	o
justo	ʒuʃto	ZuSto	o
viram	viɾɐ̃	vira*	o
dum	dũ	du*	o
conhecê	konɛze	konEze	o
inimigo	inimiɡo	inimigo	o
provar	pɾovɐɾ	provar	o
maravilhoso	mɐɾɐvilozo	maravilozo	o
aceitar	ɐzɛjtɐɾ	azEytar	o
planos	plɐnoʃ	planoS	n
esqueci	ɛʃkʷɛzi	ESkw~Ezi	o
buraco	buɾɐko	burako	o
par	pɐɾ	par	n
ligou	liɡowu	ligowu	o
meninas	mɛninɐʃ	mEninaS	o
emergência	ɛmɛɾʒensiɐ	EmErZensia	o
lua	luɐ	lua	o
fotos	fotoʃ	fotoS	o
risco	ʁiʃko	XiSko	o
encontrá	ɛnkontɾa	Enkontra	o
dizia	diziɐ	dizia	o
departamento	dɛpɐɾtɐmɛnto	dEpartamEnto	o
dessas	dɛʃsɐʃ	dESsaS	o
cheiro	kɛjɾo	kEyro	o
porcaria	poɾkɐɾiɐ	porkaria	o
estiveste	ɛʃtivɛʃtɛ	EStivEStE	o
nomes	nomɛʃ	nomES	n
vossas	voʃsɐʃ	voSsaS	o
repente	ʁɛpɛntɛ	XEpEntE	o
gelo	ʒɛlo	ZElo	o
cartas	kɐɾtɐʃ	kartaS	o
chaves	kɐvɛʃ	kavES	o
apesar	ɐpɛzɐɾ	apEzar	o
nela	nɛlɐ	nEla	o
verão	vɛɾɐ̃w̃	vEra*w*	o
paciente	pɐziɛntɛ	paziEntE	o
pega	pɛɡɐ	pEga	o
tv	tv	tv	n
cozinha	kozinɐ	kozina	o
nove	novɛ	novE	o
queira	kʷɛjɾɐ	kw~Eyra	o
dentes	dɛntɛʃ	dEntES	v
cabra	kɐbʁɐ	kabXa	o
inglês	inɡleʃ	ingleS	o
direcção	diɾɛksɐ̃w̃	dirEksa*w*	o
tiveste	tivɛʃtɛ	tivEStE	o
dado	dɐdo	dado	n
comboio	kombowjo	kombowyo	o
baixa	bajksɐ	bayksa	o
silêncio	silensio	silensio	o
espírito	ɛʃpiɾito	ESpirito	o
cristo	kɾiʃto	kriSto	o
km	k	k	n
informações	infoɾmɐsʃ	informasS	o
ficam	fikɐ̃	fika*	o
perna	pɛɾnɐ	pErna	o
detective	dɛtɛktivɛ	dEtEktivE	n
preço	pɾɛso	prEso	o
terminar	tɛɾminɐɾ	tErminar	o
cortar	koɾtɐɾ	kortar	o
teremos	tɛɾɛmoʃ	tErEmoS	o
tire	tiɾɛ	tirE	n
lidar	lidɐɾ	lidar	n
igual	iɡɐl	igal	o
chorar	koɾɐɾ	korar	o
pressão	pɾɛʃsɐ̃w̃	prESsa*w*	o
papai	pɐpaj	papay	o
gostei	ɡoʃtɛj	goStEy	o
anel	ɐnɛl	anEl	o
ias	iɐʃ	iaS	n
limpar	limpɐɾ	limpar	o
pedido	pɛdido	pEdido	o
mala	mɐlɐ	mala	o
ideias	idɛjɐʃ	idEyaS	o
saudades	sawdɐdɛʃ	sawdadES	o
esperava	ɛʃpɛɾɐvɐ	ESpErava	o
serve	sɛɾvɛ	sErvE	n
soldado	soldɐdo	soldado	o
inteiro	intɛjɾo	intEyro	o
controle	kontɾolɛ	kontrolE	o
matei	mɐtɛj	matEy	o
opinião	opiniɐ̃w̃	opinia*w*	o
preocupado	pɾɛokupɐdo	prEokupado	o
novos	novoʃ	novoS	o
relatório	ʁɛlɐtɔɾio	XElatorio	o
peixe	pɛjksɛ	pEyksE	o
dados	dɐdoʃ	dadoS	n
calças	kɐlsɐʃ	kalsaS	o
sapatos	sɐpɐtoʃ	sapatoS	o
acesso	ɐzɛʃso	azESso	o
suponho	supono	supono	o
suspeito	suʃpɛjto	suSpEyto	o
caiu	kɐju	kayu	o
roupas	ʁowupɐʃ	XowupaS	o
ocupado	okupɐdo	okupado	o
chamas	kɐmɐʃ	kamaS	o
universidade	univɛɾsidɐdɛ	univErsidadE	o
coragem	koɾɐʒɛ̃	koraZE*	o
nariz	nɐɾiʒ	nariZ	o
ponha	ponɐ	pona	o
cliente	kliɛntɛ	kliEntE	o
voar	vowɐɾ	vowar	o
chamam	kɐmɐ̃	kama*	o
estação	ɛʃtɐsɐ̃w̃	EStasa*w*	o
paris	pɐɾiʃ	pariS	n
estrela	ɛʃtɾɛlɐ	EStrEla	o
levo	lɛvo	lEvo	o
necessário	nɛzɛʃsaɾio	nEzESsario	o
escolher	ɛʃkolɛɾ	ESkolEr	o
vinho	vino	vino	o
pista	piʃtɐ	piSta	o
apresentar	ɐpʁɛzɛntɐɾ	apXEzEntar	o
pensando	pɛnsɐndo	pEnsando	o
soldados	soldɐdoʃ	soldadoS	o
cheia	kɛjɐ	kEya	o
acção	ɐksɐ̃w̃	aksa*w*	o
agradecer	ɐɡʁɐdɛzɛɾ	agXadEzEr	o
tornou	toɾnowu	tornowu	o
copo	kopo	kopo	o
responsável	ʁɛʃponsavɛl	XESponsavEl	o
divertir	divɛɾtiɾ	divErtir	o
termos	tɛɾmoʃ	tErmoS	o
noites	nowitɛʃ	nowitES	o
chá	ka	ka	o
começo	komɛso	komEso	o
longo	lonɡo	longo	o
desses	dɛʃsɛʃ	dESsES	n
deram	dɛɾɐ̃	dEra*	o
criar	kɾiɐɾ	kriar	o
parede	pɐɾɛdɛ	parEdE	o
daquele	dɐkʷɛlɛ	dakw~ElE	o
ás	aʃ	aS	o
falamos	fɐlɐmoʃ	falamoS	o
uh	u	u	o
pense	pɛnsɛ	pEnsE	o
disparar	diʃpɐɾɐɾ	diSparar	o
atirar	ɐtiɾɐɾ	atirar	o
pago	pɐɡo	pago	o
continue	kontinuɛ	kontinuE	v
americanos	ɐmɛɾikɐnoʃ	amErikanoS	o
cuidar	kujdɐɾ	kuydar	o
espectáculo	ɛʃpɛktakulo	ESpEktakulo	o
subs	subʃ	subS	n
dão	dɐ̃w̃	da*w*	o
mentira	mɛntiɾɐ	mEntira	o
tamanho	tɐmɐno	tamano	o
perdão	pɛɾdɐ̃w̃	pErda*w*	o
cu	ku	ku	n
férias	feɾiɐʃ	feriaS	o
caramba	kɐɾɐmbɐ	karamba	o
novas	novɐʃ	novaS	n
agentes	ɐʒɛntɛʃ	aZEntES	o
pedra	pɛdʁɐ	pEdXa	o
investigação	invɛʃtiɡɐsɐ̃w̃	invEStigasa*w*	o
edifício	ɛdifizio	Edifizio	o
come	komɛ	komE	n
preparado	pɾɛpɐɾɐdo	prEparado	o
chance	kɐnsɛ	kansE	n
doce	dozɛ	dozE	o
avô	ɐvo	avo	o
combate	kombɐtɛ	kombatE	o
verde	vɛɾdɛ	vErdE	o
memória	mɛmɔɾiɐ	mEmoria	o
calhar	kɐlɐɾ	kalar	o
voo	vowo	vowo	o
mexam	mɛksɐ̃	mEksa*	o
evitar	ɛvitɐɾ	Evitar	o
levantar	lɛvɐntɐɾ	lEvantar	o
entende	ɛntɛndɛ	EntEndE	o
visita	vizitɐ	vizita	o
animal	ɐnimɐl	animal	n
bala	bɐlɐ	bala	o
vens	vɛnʃ	vEnS	o
salvo	sɐlvo	salvo	n
caras	kɐɾɐʃ	karaS	o
trato	tɾɐto	trato	o
abra	ɐbʁɐ	abXa	o
fará	fɐɾa	fara	o
laboratório	lɐboɾɐtɔɾio	laboratorio	o
confiança	konfiɐnsɐ	konfiansa	o
daquela	dɐkʷɛlɐ	dakw~Ela	o
homicídio	omizidio	omizidio	o
filmes	filmɛʃ	filmES	v
ficará	fikɐɾa	fikara	o
fé	fe	fe	o
imenso	imɛnso	imEnso	o
discutir	diʃkutiɾ	diSkutir	o
batalha	bɐtɐlɐ	batala	o
branca	bɾɐnkɐ	branka	o
comum	komũ	komu*	o
rir	ʁiɾ	Xir	o
encontra	ɛnkontɾɐ	Enkontra	o
entregar	ɛntɾɛɡɐɾ	EntrEgar	o
caralho	kɐɾɐlo	karalo	o
acontecendo	ɐkontɛzɛndo	akontEzEndo	o
errada	ɛʁɐdɐ	EXada	o
cheguei	kɛɡʷɛj	kEgw~Ey	o
desculpas	dɛʃkulpɐʃ	dESkulpaS	o
telemóvel	tɛlɛmɔvɛl	tElEmovEl	o
duma	dumɐ	duma	n
tome	tomɛ	tomE	n
máximo	maksimo	maksimo	o
preto	pɾɛto	prEto	o
ido	ido	ido	n
cães	kɐ̃j̃ʃ	ka*y*S	o
lugares	luɡɐɾɛʃ	lugarES	o
cantar	kɐntɐɾ	kantar	o
som	sõ	so*	n
terei	tɛɾɛj	tErEy	o
restaurante	ʁɛʃtawɾɐntɛ	XEStawrantE	o
escute	ɛʃkutɛ	ESkutE	o
língua	linɡɐ	linga	o
li	li	li	n
serei	sɛɾɛj	sErEy	o
ligo	liɡo	ligo	o
seres	sɛɾɛʃ	sErES	o
agradeço	ɐɡʁɐdɛso	agXadEso	o
velocidade	vɛlozidɐdɛ	vElozidadE	o
tia	tiɐ	tia	n
árvore	aɾvoɾɛ	arvorE	o
dança	dɐnsɐ	dansa	o
brilhante	bɾilɐntɛ	brilantE	o
limpo	limpo	limpo	o
parque	pɐɾkʷɛ	parkw~E	o
vendo	vɛndo	vEndo	o
andas	ɐndɐʃ	andaS	o
princesa	pɾinsɛzɐ	prinsEza	o
pescoço	pɛʃkoso	pESkoso	o
aguenta	ɐɡʷɛntɐ	agw~Enta	o
responder	ʁɛʃpondɛɾ	XESpondEr	n
casaco	kɐzɐko	kazako	o
natureza	nɐtuɾɛzɐ	naturEza	o
costumava	koʃtumɐvɐ	koStumava	o
encontraram	ɛnkontɾɐɾɐ̃	Enkontrara*	o
torna	toɾnɐ	torna	o
gozar	ɡozɐɾ	gozar	o
troca	tɾokɐ	troka	o
fechar	fɛkɐɾ	fEkar	o
praia	pɾɐjɐ	praya	n
médicos	medikoʃ	medikoS	o
início	inizio	inizio	o
apoio	ɐpowjo	apowyo	o
mexer	mɛksɛɾ	mEksEr	o
céus	sɛwʃ	sEwS	o
gostam	ɡoʃtɐ̃	goSta*	o
vindos	vindoʃ	vindoS	o
puder	pudɛɾ	pudEr	o
preocupar	pɾɛokupɐɾ	prEokupar	o
imaginar	imɐʒinɐɾ	imaZinar	o
xerife	ʃɛɾifɛ	SErifE	o
vimos	vimoʃ	vimoS	o
corrida	koʁidɐ	koXida	n
verificar	vɛɾifikɐɾ	vErifikar	o
verdadeira	vɛɾdɐdɛjɾɐ	vErdadEyra	o
esperto	ɛʃpɛɾto	ESpErto	o
tente	tɛntɛ	tEntE	o
fotografia	fotoɡʁɐfiɐ	fotogXafia	o
devido	dɛvido	dEvido	o
mato	mɐto	mato	o
ponte	pontɛ	pontE	o
haverá	ɐvɛɾa	avEra	o
controlar	kontɾolɐɾ	kontrolar	o
vergonha	vɛɾɡonɐ	vErgona	o
perdemos	pɛɾdɛmoʃ	pErdEmoS	o
porreiro	poʁɛjɾo	poXEyro	o
série	seɾiɛ	seriE	o
londres	londɾɛʃ	londrES	o
deviam	dɛviɐ̃	dEvia*	o
atrasado	ɐtʁɐzɐdo	atXazado	o
morre	moʁɛ	moXE	o
forças	foɾsɐʃ	forsaS	o
relógio	ʁɛlɔʒio	XEloZio	o
beleza	bɛlɛzɐ	bElEza	o
luzes	luzɛʃ	luzES	o
arte	ɐɾtɛ	artE	o
doença	dowɛnsɐ	dowEnsa	o
monstro	monstɾo	monstro	o
falas	fɐlɐʃ	falaS	o
conseguiste	konsɛɡʷiʃtɛ	konsEgw~iStE	o
portas	poɾtɐʃ	portaS	n
exatamente	ɛzɐtɐmɛntɛ	EzatamEntE	o
gato	ɡɐto	gato	o
ligue	liɡʷɛ	ligw~E	o
pegue	pɛɡʷɛ	pEgw~E	o
apanhei	ɐpɐnɛj	apanEy	o
apareceu	ɐpɐɾɛzew	aparEzew	o
carrinha	kɐʁinɐ	kaXina	o
cadeira	kɐdɛjɾɐ	kadEyra	o
pontos	pontoʃ	pontoS	n
infelizmente	infɛliʒmɛntɛ	infEliZmEntE	o
pensam	pɛnsɐ̃	pEnsa*	o
mamãe	mɐmɐ̃j̃	mama*y*	o
esqueça	ɛʃkʷɛsɐ	ESkw~Esa	o
longa	lonɡɐ	longa	o
distância	diʃtansiɐ	diStansia	o
barulho	bɐɾulo	barulo	o
unidade	unidɐdɛ	unidadE	o
processo	pɾozɛʃso	prozESso	o
enviar	ɛnviɐɾ	Enviar	o
doido	dowido	dowido	o
tido	tido	tido	o
busca	buʃkɐ	buSka	o
cadeia	kɐdɛjɐ	kadEya	o
espada	ɛʃpɐdɐ	ESpada	o
prefiro	pɾɛfiɾo	prEfiro	o
humana	umɐnɐ	umana	o
prestes	pɾɛʃtɛʃ	prEStES	o
andado	ɐndɐdo	andado	o
respirar	ʁɛʃpiɾɐɾ	XESpirar	o
correu	koʁew	koXew	o
estrelas	ɛʃtɾɛlɐʃ	EStrElaS	o
imagem	imɐʒɛ̃	imaZE*	o
vídeo	vidɛo	vidEo	o
grávida	ɡɾavidɐ	gravida	o
velhos	vɛloʃ	vEloS	o
central	sɛntɾɐl	sEntral	n
justiça	ʒuʃtisɐ	ZuStisa	o
vieram	viɛɾɐ̃	viEra*	o
conhecemos	konɛzɛmoʃ	konEzEmoS	o
faculdade	fɐkuldɐdɛ	fakuldadE	o
data	dɐtɐ	data	n
juntar	ʒuntɐɾ	Zuntar	o
faca	fɐkɐ	faka	o
simpático	simpatiko	simpatiko	o
irão	iɾɐ̃w̃	ira*w*	o
ouçam	owusɐ̃	owusa*	o
conhecido	konɛzido	konEzido	o
autocarro	awtokɐʁo	awtokaXo	o
acorda	ɐkoɾdɐ	akorda	o
certamente	sɛɾtɐmɛntɛ	sErtamEntE	o
escapar	ɛʃkɐpɐɾ	ESkapar	o
terem	tɛɾɛ̃	tErE*	o
ensinar	ɛnsinɐɾ	Ensinar	o
várias	vaɾiɐʃ	variaS	o
unidos	unidoʃ	unidoS	o
beijo	bɛjʒo	bEyZo	o
auto	awto	awto	n
descer	dɛʃsɛɾ	dESsEr	o
sucesso	suzɛʃso	suzESso	o
líder	lidɛɾ	lidEr	o
dedos	dɛdoʃ	dEdoS	o
conseguia	konsɛɡʷiɐ	konsEgw~ia	o
acabado	ɐkɐbɐdo	akabado	o
rico	ʁiko	Xiko	n
magoar	mɐɡowɐɾ	magowar	o
flores	floɾɛʃ	florES	o
porco	poɾko	porko	o
toque	tokʷɛ	tokw~E	n
levem	lɛvɛ̃	lEvE*	o
estados	ɛʃtɐdoʃ	EStadoS	o
normalmente	noɾmɐlmɛntɛ	normalmEntE	o
bordo	boɾdo	bordo	o
vieste	viɛʃtɛ	viEStE	o
louca	lowukɐ	lowuka	o
carreira	kɐʁɛjɾɐ	kaXEyra	o
milhares	milɐɾɛʃ	milarES	o
futebol	futɛbol	futEbol	o
mo	mo	mo	n
conseguem	konsɛɡʷɛ̃	konsEgw~E*	o
ficamos	fikɐmoʃ	fikamoS	o
dás	daʃ	daS	o
acordar	ɐkoɾdɐɾ	akordar	o
quieto	kʷiɛto	kw~iEto	o
conduzir	konduziɾ	konduzir	o
vinte	vintɛ	vintE	o
histórias	iʃtɔɾiɐʃ	iStoriaS	o
braços	bɾɐsoʃ	brasoS	o
encontrado	ɛnkontɾɐdo	Enkontrado	o
sobreviver	sobʁɛvivɛɾ	sobXEvivEr	o
quinta	kʷintɐ	kw~inta	o
sir	siɾ	sir	n
maria	mɐɾiɐ	maria	n
rosto	ʁoʃto	XoSto	o
sacana	sɐkɐnɐ	sakana	o
total	totɐl	total	n
afasta	ɐfɐʃtɐ	afaSta	o
valor	vɐloɾ	valor	n
cansado	kɐnsɐdo	kansado	o
estilo	ɛʃtilo	EStilo	o
segue	sɛɡʷɛ	sEgw~E	n
visão	vizɐ̃w̃	viza*w*	o
aulas	awlɐʃ	awlaS	o
banda	bɐndɐ	banda	o
ridículo	ʁidikulo	Xidikulo	o
mexe	mɛksɛ	mEksE	o
chame	kɐmɛ	kamE	o
servir	sɛɾviɾ	sErvir	o
parceiro	pɐɾsɛjɾo	parsEyro	o
ouvido	owuvido	owuvido	o
quão	kɐ̃w̃	ka*w*	o
aula	awlɐ	awla	o
passe	pɐʃsɛ	paSsE	s
gay	ɡɐj	gay	n
deixes	dɛjksɛʃ	dEyksES	o
estranha	ɛʃtɾɐnɐ	EStrana	o
especialmente	ɛʃpɛziɐlmɛntɛ	ESpEzialmEntE	o
via	viɐ	via	o
milhão	milɐ̃w̃	mila*w*	o
excepto	ɛsɛpto	EsEpto	o
venho	vɛno	vEno	o
movimento	movimɛnto	movimEnto	o
esperando	ɛʃpɛɾɐndo	ESpErando	o
santo	sɐnto	santo	o
deixo	dɛjkso	dEykso	o
gabinete	ɡɐbinɛtɛ	gabinEtE	o
inteira	intɛjɾɐ	intEyra	o
perfeita	pɛɾfɛjtɐ	pErfEyta	o
táxi	taksi	taksi	o
vemo	vɛmo	vEmo	o
números	numɛɾoʃ	numEroS	o
possamos	poʃsɐmoʃ	poSsamoS	o
dêem	deɛ̃	deE*	o
cavalheiros	kɐvɐlɛjɾoʃ	kavalEyroS	o
cinema	sinɛmɐ	sinEma	n
corte	koɾtɛ	kortE	o
serem	sɛɾɛ̃	sErE*	o
óptima	ɔptimɐ	optima	o
noiva	nowivɐ	nowiva	o
posto	poʃto	poSto	o
más	maʃ	maS	o
cale	kɐlɛ	kalE	o
época	epokɐ	epoka	o
oeste	owɛʃtɛ	owEStE	o
lixar	liksɐɾ	liksar	o
atacar	ɐtɐkɐɾ	atakar	o
nervoso	nɛɾvozo	nErvozo	o
éramos	eɾɐmoʃ	eramoS	o
felizes	fɛlizɛʃ	fElizES	o
ando	ɐndo	ando	o
classe	klɐʃsɛ	klaSsE	o
orgulho	oɾɡlo	orglo	o
fantasma	fɐntɐʃmɐ	fantaSma	o
encontramos	ɛnkontɾɐmoʃ	EnkontramoS	o
nacional	nɐzionɐl	nazional	o
chamou	kɐmowu	kamowu	o
marca	mɐɾkɐ	marka	o
idiotas	idiotɐʃ	idiotaS	o
aeroporto	ɐɛɾopoɾto	aEroporto	o
pensou	pɛnsowu	pEnsowu	o
dono	dono	dono	o
maldição	mɐldisɐ̃w̃	maldisa*w*	o
tirem	tiɾɛ̃	tirE*	o
andando	ɐndɐndo	andando	o
jornal	ʒoɾnɐl	Zornal	o
navio	nɐvio	navio	o
sinais	sinajʃ	sinayS	n
casas	kɐzɐʃ	kazaS	o
miúdas	miẃdɐʃ	miwdaS	o
jovens	ʒovɛnʃ	ZovEnS	o
vás	vaʃ	vaS	o
dói	dõj̃	do*y*	o
cheira	kɛjɾɐ	kEyra	o
clientes	kliɛntɛʃ	kliEntES	o
jogos	ʒoɡoʃ	ZogoS	o
roubou	ʁowubowu	Xowubowu	o
casado	kɐzɐdo	kazado	o
william	williɐ̃	willia*	o
morreram	moʁɛɾɐ̃	moXEra*	o
recuperar	ʁɛkupɛɾɐɾ	XEkupErar	o
desistir	dɛziʃtiɾ	dEziStir	o
corpos	koɾpoʃ	korpoS	o
telefonar	tɛlɛfonɐɾ	tElEfonar	o
buscá	buʃka	buSka	o
queiras	kʷɛjɾɐʃ	kw~EyraS	o
tantas	tɐntɐʃ	tantaS	o
director	diɾɛktoɾ	dirEktor	n
escuro	ɛʃkuɾo	ESkuro	o
steve	stɛvɛ	stEvE	o
recebi	ʁɛzɛbi	XEzEbi	o
aviso	ɐvizo	avizo	o
sexta	sɛstɐ	sEsta	o
traga	tɾɐɡɐ	traga	o
pede	pɛdɛ	pEdE	o
absolutamente	ɐbsolutɐmɛntɛ	absolutamEntE	o
fonte	fontɛ	fontE	o
apanha	ɐpɐnɐ	apana	o
militar	militɐɾ	militar	o
voce	vozɛ	vozE	o
lisa	lizɐ	liza	o
peito	pɛjto	pEyto	o
soubesse	sowubɛʃsɛ	sowubESsE	o
sentimentos	sɛntimɛntoʃ	sEntimEntoS	o
calor	kɐloɾ	kalor	o
gritar	ɡɾitɐɾ	gritar	o
vêem	veɛ̃	veE*	o
inocente	inozɛntɛ	inozEntE	o
major	mɐʒoɾ	maZor	n
colega	kolɛɡɐ	kolEga	o
canção	kɐnsɐ̃w̃	kansa*w*	o
vítimas	vitimɐʃ	vitimaS	o
profissional	pɾofiʃsionɐl	profiSsional	o
dever	dɛvɛɾ	dEvEr	o
uso	uzo	uzo	o
malta	mɐltɐ	malta	n
teoria	tɛoɾiɐ	tEoria	o
entendi	ɛntɛndi	EntEndi	o
lsso	lso	lso	o
meninos	mɛninoʃ	mEninoS	o
baile	bajlɛ	baylE	o
antigo	ɐntiɡo	antigo	o
ameaça	ɐmɛɐsɐ	amEasa	o
oferecer	ofɛɾɛzɛɾ	ofErEzEr	o
notícia	notiziɐ	notizia	o
vento	vɛnto	vEnto	o
partido	pɐɾtido	partido	o
disser	diʃsɛɾ	diSsEr	o
mapa	mɐpɐ	mapa	o
dedo	dɛdo	dEdo	o
jamais	ʒɐmajʃ	ZamayS	o
paga	pɐɡɐ	paga	o
amar	ɐmɐɾ	amar	o
ligado	liɡɐdo	ligado	o
sentado	sɛntɐdo	sEntado	o
correcto	koʁɛkto	koXEkto	o
agradável	ɐɡʁɐdavɛl	agXadavEl	o
vivos	vivoʃ	vivoS	o
revisão	ʁɛvizɐ̃w̃	XEviza*w*	o
maldita	mɐlditɐ	maldita	o
visitar	vizitɐɾ	vizitar	o
vários	vaɾioʃ	varioS	o
eua	ewɐ	ewa	o
acreditas	ɐkʁɛditɐʃ	akXEditaS	o
faremos	fɐɾɛmoʃ	farEmoS	o
descansar	dɛʃkɐnsɐɾ	dESkansar	o
aspecto	ɐʃpɛkto	aSpEkto	o
deixado	dɛjksɐdo	dEyksado	o
ouvidos	owuvidoʃ	owuvidoS	o
ajudem	ɐʒudɛ̃	aZudE*	o
tiveram	tivɛɾɐ̃	tivEra*	o
pôs	poʃ	poS	o
terceiro	tɛɾsɛjɾo	tErsEyro	o
polícias	poliziɐʃ	poliziaS	o
chapéu	kɐpɛw	kapEw	o
equipe	ɛkʷipɛ	Ekw~ipE	o
ted	tɛd	tEd	n
príncipe	pɾinsipɛ	prinsipE	o
escreveu	ɛʃkɾɛvew	ESkrEvew	o
impedir	impɛdiɾ	impEdir	o
decidir	dɛzidiɾ	dEzidir	o
peso	pɛzo	pEzo	n
deuses	dewzɛʃ	dewzES	o
importo	impoɾto	importo	o
pequenos	pɛkʷɛnoʃ	pEkw~EnoS	o
piloto	piloto	piloto	o
ruas	ʁuɐʃ	XuaS	o
confia	konfiɐ	konfia	o
interior	intɛɾioɾ	intErior	n
regressar	ʁɛɡʁɛʃsɐɾ	XEgXESsar	o
estúpida	ɛʃtupidɐ	EStupida	o
obviamente	obviɐmɛntɛ	obviamEntE	o
demorar	dɛmoɾɐɾ	dEmorar	o
depende	dɛpɛndɛ	dEpEndE	o
fingir	finʒiɾ	finZir	o
floresta	floɾɛʃtɐ	florESta	o
magia	mɐʒiɐ	maZia	o
universo	univɛɾso	univErso	o
conhecia	konɛziɐ	konEzia	o
iremos	iɾɛmoʃ	irEmoS	o
pude	pudɛ	pudE	o
leite	lɛjtɛ	lEytE	o
caro	kɐɾo	karo	o
bolo	bolo	bolo	n
achou	ɐkowu	akowu	o
descobri	dɛʃkobʁi	dESkobXi	o
chuva	kuvɐ	kuva	o
digam	diɡɐ̃	diga*	o
mudança	mudɐnsɐ	mudansa	o
fá	fa	fa	o
comecei	komɛzɛj	komEzEy	o
exacto	ɛzɐkto	Ezakto	o
viemos	viɛmoʃ	viEmoS	o
cavalos	kɐvɐloʃ	kavaloS	o
eie	ɛjɛ	EyE	o
crer	kɾɛɾ	krEr	o
aberta	ɐbɛɾtɐ	abErta	o
cirurgia	siɾuɾʒiɐ	sirurZia	o
acredite	ɐkʁɛditɛ	akXEditE	o
poderes	podɛɾɛʃ	podErES	o
deitar	dɛjtɐɾ	dEytar	o
merdas	mɛɾdɐʃ	mErdaS	o
matt	mɐtt	matt	n
entanto	ɛntɐnto	Entanto	o
diante	diɐntɛ	diantE	o
daniel	dɐniɛl	daniEl	n
ferido	fɛɾido	fErido	o
interesse	intɛɾɛʃsɛ	intErESsE	o
tirou	tiɾowu	tirowu	o
material	mɐtɛɾiɐl	matErial	n
larry	lɐʁj	laXy	o
leste	lɛʃtɛ	lEStE	o
testes	tɛʃtɛʃ	tEStES	n
feita	fɛjtɐ	fEyta	o
assistente	ɐʃsiʃtɛntɛ	aSsiStEntE	o
angeles	ɐnʒɛlɛʃ	anZElES	o
bocadinho	bokɐdino	bokadino	o
aguentar	ɐɡʷɛntɐɾ	agw~Entar	o
rapidamente	ʁɐpidɐmɛntɛ	XapidamEntE	o
juiz	ʒujʒ	ZuyZ	o
lee	lɛɛ	lEE	n
fumar	fumɐɾ	fumar	o
maiores	mɐjoɾɛʃ	mayorES	o
política	politikɐ	politika	o
óbvio	ɔbvio	obvio	o
sê	se	se	o
srta	sɾtɐ	srta	o
desligar	dɛʃliɡɐɾ	dESligar	o
momentos	momɛntoʃ	momEntoS	o
acalma	ɐkɐlmɐ	akalma	o
construir	konstɾujɾ	konstruyr	o
escrito	ɛʃkɾito	ESkrito	o
vírus	viɾuʃ	viruS	o
vemos	vɛmoʃ	vEmoS	o
treta	tɾɛtɐ	trEta	o
pedaço	pɛdɐso	pEdaso	o
importas	impoɾtɐʃ	importaS	o
tivesses	tivɛʃsɛʃ	tivESsES	o
anna	ɐnnɐ	anna	n
guardas	ɡɐɾdɐʃ	gardaS	o
deixaste	dɛjksɐʃtɛ	dEyksaStE	o
acabaram	ɐkɐbɐɾɐ̃	akabara*	o
jason	ʒɐzõ	Zazo*	n
martin	mɐɾtĩ	marti*	n
inglaterra	inɡlɐtɛʁɐ	inglatEXa	o
mercado	mɛɾkɐdo	mErkado	o
natural	nɐtuɾɐl	natural	n
bebê	bɛbe	bEbe	o
procurando	pɾokuɾɐndo	prokurando	o
perda	pɛɾdɐ	pErda	o
receio	ʁɛzɛjo	XEzEyo	o
agir	ɐʒiɾ	aZir	o
entendes	ɛntɛndɛʃ	EntEndES	o
poucos	powukoʃ	powukoS	o
treinador	tɾɛjnɐdoɾ	trEynador	o
confusão	konfuzɐ̃w̃	konfuza*w*	o
julgamento	ʒulɡɐmɛnto	ZulgamEnto	o
deseja	dɛzɛʒɐ	dEzEZa	o
roma	ʁomɐ	Xoma	n
íamos	iɐmoʃ	iamoS	o
mataram	mɐtɐɾɐ̃	matara*	o
mano	mɐno	mano	o
pertence	pɛɾtɛnsɛ	pErtEnsE	o
lago	lɐɡo	lago	o
dera	dɛɾɐ	dEra	o
chocolate	kokolɐtɛ	kokolatE	n
iam	iɐ̃	ia*	o
daqueles	dɐkʷɛlɛʃ	dakw~ElES	o
patrão	pɐtʁɐ̃w̃	patXa*w*	o
comprei	kompɾɛj	komprEy	o
fizer	fizɛɾ	fizEr	o
segredos	sɛɡʁɛdoʃ	sEgXEdoS	o
ganha	ɡɐnɐ	gana	o
senador	sɛnɐdoɾ	sEnador	o
limpa	limpɐ	limpa	n
corredor	koʁɛdoɾ	koXEdor	o
testemunha	tɛʃtɛmunɐ	tEStEmuna	o
uau	uaw	uaw	o
arranja	ɐʁɐnʒɐ	aXanZa	o
rede	ʁɛdɛ	XEdE	v
notas	notɐʃ	notaS	o
descobriu	dɛʃkobʁiw	dESkobXiw	o
camisa	kɐmizɐ	kamiza	o
dava	dɐvɐ	dava	o
crescer	kɾɛʃsɛɾ	krESsEr	o
resultado	ʁɛzultɐdo	XEzultado	o
aconteça	ɐkontɛsɐ	akontEsa	o
culpado	kulpɐdo	kulpado	o
lar	lɐɾ	lar	o
bebe	bɛbɛ	bEbE	o
ovos	ovoʃ	ovoS	o
io	io	io	n
interessado	intɛɾɛʃsɐdo	intErESsado	o
antiga	ɐntiɡɐ	antiga	o
tantos	tɐntoʃ	tantoS	o
pessoalmente	pɛʃsowɐlmɛntɛ	pESsowalmEntE	o
passaram	pɐʃsɐɾɐ̃	paSsara*	o
carl	kɐɾl	karl	o
perguntei	pɛɾɡntɛj	pErgntEy	o
concordo	konkoɾdo	konkordo	o
andam	ɐndɐ̃	anda*	o
aparece	ɐpɐɾɛzɛ	aparEzE	o
custa	kuʃtɐ	kuSta	o
partida	pɐɾtidɐ	partida	o
andava	ɐndɐvɐ	andava	o
vegas	vɛɡɐʃ	vEgaS	n
sentem	sɛntɛ̃	sEntE*	o
instante	instɐntɛ	instantE	o
parecido	pɐɾɛzido	parEzido	o
tendo	tɛndo	tEndo	o
van	vɐ̃	va*	n
balas	bɐlɐʃ	balaS	n
costa	koʃtɐ	koSta	n
presa	pɾɛzɐ	prEza	o
gordo	ɡoɾdo	gordo	o
fotografias	fotoɡʁɐfiɐʃ	fotogXafiaS	o
luke	lukɛ	lukE	n
vitória	vitɔɾiɐ	vitoria	o
bolsa	bolsɐ	bolsa	o
sensação	sɛnsɐsɐ̃w̃	sEnsasa*w*	o
podiam	podiɐ̃	podia*	o
inimigos	inimiɡoʃ	inimigoS	o
fuga	fuɡɐ	fuga	o
mandei	mɐndɛj	mandEy	o
despacha	dɛʃpɐkɐ	dESpaka	o
género	ʒenɛɾo	ZenEro	o
fugiu	fuʒiw	fuZiw	o
merece	mɛɾɛzɛ	mErEzE	o
imprensa	impɾɛnsɐ	imprEnsa	o
oferta	ofɛɾtɐ	ofErta	o
voltas	voltɐʃ	voltaS	n
estejam	ɛʃtɛʒɐ̃	EStEZa*	o
tragam	tɾɐɡɐ̃	traga*	o
ganhou	ɡɐnowu	ganowu	o
poderoso	podɛɾozo	podErozo	o
ficaria	fikɐɾiɐ	fikaria	o
tretas	tɾɛtɐʃ	trEtaS	o
detesto	dɛtɛʃto	dEtESto	o
somente	somɛntɛ	somEntE	o
explosão	ɛsplozɐ̃w̃	Esploza*w*	o
direitos	diɾɛjtoʃ	dirEytoS	o
encontrámos	ɛnkontɾamoʃ	EnkontramoS	o
gás	ɡaʃ	gaS	o
bilhete	bilɛtɛ	bilEtE	o
mete	mɛtɛ	mEtE	n
quisesse	kʷizɛʃsɛ	kw~izESsE	o
mate	mɐtɛ	matE	n
treino	tɾɛjno	trEyno	o
vingança	vinɡɐnsɐ	vingansa	o
responde	ʁɛʃpondɛ	XESpondE	o
serviços	sɛɾvisoʃ	sErvisoS	o
presença	pɾɛzɛnsɐ	prEzEnsa	o
montanha	montɐnɐ	montana	o
tempestade	tɛmpɛʃtɐdɛ	tEmpEStadE	o
razões	ʁɐzʃ	XazS	o
giro	ʒiɾo	Ziro	n
dean	dɛɐ̃	dEa*	n
contrato	kontɾɐto	kontrato	o
cofre	kofʁɛ	kofXE	o
voltei	voltɛj	voltEy	o
raiva	ʁajvɐ	Xayva	o
vira	viɾɐ	vira	o
chegaram	kɛɡɐɾɐ̃	kEgara*	o
tchau	tkaw	tkaw	o
fecha	fɛkɐ	fEka	o
estejas	ɛʃtɛʒɐʃ	EStEZaS	o
levaram	lɛvɐɾɐ̃	lEvara*	o
objectivo	obʒɛktivo	obZEktivo	o
assassinato	ɐʃsɐʃsinɐto	aSsaSsinato	o
sábado	sabɐdo	sabado	o
conhecem	konɛzɛ̃	konEzE*	o
mantenha	mɐntɛnɐ	mantEna	o
casos	kɐzoʃ	kazoS	o
alô	ɐlo	alo	o
primo	pɾimo	primo	n
farto	fɐɾto	farto	o
geral	ʒɛɾɐl	ZEral	o
solta	soltɐ	solta	o
rosa	ʁozɐ	Xoza	n
mataste	mɐtɐʃtɛ	mataStE	o
respostas	ʁɛʃpoʃtɐʃ	XESpoStaS	o
saltar	sɐltɐɾ	saltar	o
jardim	ʒɐɾdĩ	Zardi*	o
frança	fɾɐnsɐ	fransa	o
próprios	pɾɔpʁioʃ	propXioS	o
grave	ɡɾɐvɛ	gravE	n
regra	ʁɛɡʁɐ	XEgXa	o
avisar	ɐvizɐɾ	avizar	o
efeito	ɛfɛjto	EfEyto	o
policia	poliziɐ	polizia	o
garrafa	ɡɐʁɐfɐ	gaXafa	o
jones	ʒonɛʃ	ZonES	n
desaparecer	dɛzɐpɐɾɛzɛɾ	dEzaparEzEr	o
aberto	ɐbɛɾto	abErto	o
entrem	ɛntɾɛ̃	EntrE*	o
vestir	vɛʃtiɾ	vEStir	o
imbecil	imbɛzil	imbEzil	o
algures	ɐlɡɾɛʃ	algrES	o
aparentemente	ɐpɐɾɛntɛmɛntɛ	aparEntEmEntE	o
conhecimento	konɛzimɛnto	konEzimEnto	o
virar	viɾɐɾ	virar	o
torre	toʁɛ	toXE	o
cia	siɐ	sia	n
campeão	kɐmpɛɐ̃w̃	kampEa*w*	o
arthur	ɐɾtuɾ	artur	n
tecnologia	tɛknoloʒiɐ	tEknoloZia	o
sociedade	soziɛdɐdɛ	soziEdadE	o
thomas	tomɐʃ	tomaS	n
responsabilidade	ʁɛʃponsɐbilidɐdɛ	XESponsabilidadE	o
bate	bɐtɛ	batE	v
afastem	ɐfɐʃtɛ̃	afaStE*	o
encontraste	ɛnkontɾɐʃtɛ	EnkontraStE	o
companheiro	kompɐnɛjɾo	kompanEyro	o
projecto	pɾoʒɛkto	proZEkto	o
equipamento	ɛkʷipɐmɛnto	Ekw~ipamEnto	o
terás	tɛɾaʃ	tEraS	o
prédio	pɾedio	predio	o
salvou	sɐlvowu	salvowu	o
scott	skott	skott	n
estudar	ɛʃtudɐɾ	EStudar	o
queriam	kʷɛɾiɐ̃	kw~Eria*	o
propriedade	pɾopʁiɛdɐdɛ	propXiEdadE	o
vinha	vinɐ	vina	o
rock	ʁokk	Xokk	n
yeah	jɛɐ	yEa	r
pro	pɾo	pro	n
pegou	pɛɡowu	pEgowu	o
pareceu	pɐɾɛzew	parEzew	o
médica	medikɐ	medika	o
massa	mɐʃsɐ	maSsa	o
kyle	kjlɛ	kylE	o
camião	kɐmiɐ̃w̃	kamia*w*	o
maus	mawʃ	mawS	o
helicóptero	ɛlikɔptɛɾo	ElikoptEro	o
partes	pɐɾtɛʃ	partES	v
ciência	siensiɐ	siensia	o
acabaste	ɐkɐbɐʃtɛ	akabaStE	o
resta	ʁɛʃtɐ	XESta	o
emily	ɛmilj	Emily	o
haja	ɐʒɐ	aZa	o
zero	zɛɾo	zEro	n
prender	pɾɛndɛɾ	prEndEr	o
pesquisa	pɛʃkʷizɐ	pESkw~iza	o
aproximar	ɐpʁoksimɐɾ	apXoksimar	o
sean	sɛɐ̃	sEa*	o
voltem	voltɛ̃	voltE*	o
reino	ʁɛjno	XEyno	o
nota	notɐ	nota	o
big	biɡ	big	a
simon	simõ	simo*	n
opção	opsɐ̃w̃	opsa*w*	o
desaparece	dɛzɐpɐɾɛzɛ	dEzaparEzE	o
extra	ɛstɾɐ	Estra	n
centenas	sɛntɛnɐʃ	sEntEnaS	o
assalto	ɐʃsɐlto	aSsalto	o
acontecido	ɐkontɛzido	akontEzido	o
apanhou	ɐpɐnowu	apanowu	o
pressa	pɾɛʃsɐ	prESsa	o
curso	kuɾso	kurso	o
completo	komplɛto	komplEto	o
resultados	ʁɛzultɐdoʃ	XEzultadoS	o
vencer	vɛnsɛɾ	vEnsEr	o
fossem	foʃsɛ̃	foSsE*	o
vinda	vindɐ	vinda	o
brincadeira	bɾinkɐdɛjɾɐ	brinkadEyra	o
explodir	ɛsplodiɾ	Esplodir	o
complicado	komplikɐdo	komplikado	o
ouviram	owuviɾɐ̃	owuvira*	o
loucos	lowukoʃ	lowukoS	o
solução	solusɐ̃w̃	solusa*w*	o
boleia	bolɛjɐ	bolEya	o
fosses	foʃsɛʃ	foSsES	n
lembre	lɛmbɾɛ	lEmbrE	o
conte	kontɛ	kontE	o
percebe	pɛɾsɛbɛ	pErsEbE	o
levante	lɛvɐntɛ	lEvantE	o
ministro	miniʃtɾo	miniStro	o
princípio	pɾinsipio	prinsipio	o
méxico	meksiko	meksiko	o
mexa	mɛksɐ	mEksa	o
perfeitamente	pɛɾfɛjtɐmɛntɛ	pErfEytamEntE	o
eis	ɛjʃ	EyS	o
usou	uzowu	uzowu	o
preocupada	pɾɛokupɐdɐ	prEokupada	o
estaremos	ɛʃtɐɾɛmoʃ	EStarEmoS	o
adam	ɐdɐ̃	ada*	n
corta	koɾtɐ	korta	o
muda	mudɐ	muda	o
ossos	oʃsoʃ	oSsoS	o
califórnia	kɐlifɔɾniɐ	kalifornia	o
secretária	sɛkʁɛtaɾiɐ	sEkXEtaria	o
autorização	awtoɾizɐsɐ̃w̃	awtorizasa*w*	o
ultimamente	ultimɐmɛntɛ	ultimamEntE	o
morgan	moɾɡɐ̃	morga*	n
presos	pɾɛzoʃ	prEzoS	o
mel	mɛl	mEl	o
lê	le	le	o
avançar	ɐvɐnsɐɾ	avansar	o
terão	tɛɾɐ̃w̃	tEra*w*	o
terceira	tɛɾsɛjɾɐ	tErsEyra	o
bairro	bajʁo	bayXo	o
new	nɛw	nEw	a
exame	ɛzɐmɛ	EzamE	o
adora	ɐdoɾɐ	adora	o
decidi	dɛzidi	dEzidi	o
assuntos	ɐʃsuntoʃ	aSsuntoS	o
amava	ɐmɐvɐ	amava	o
don	dõ	do*	n
entendeu	ɛntɛndew	EntEndew	o
telhado	tɛlɐdo	tElado	o
viajar	viɐʒɐɾ	viaZar	o
negra	nɛɡʁɐ	nEgXa	o
truque	tɾukʷɛ	trukw~E	o
membros	mɛmbɾoʃ	mEmbroS	o
árvores	aɾvoɾɛʃ	arvorES	o
phil	pil	pil	o
tratamento	tɾɐtɐmɛnto	tratamEnto	o
deixaram	dɛjksɐɾɐ̃	dEyksara*	o
conto	konto	konto	n
modelo	modɛlo	modElo	o
imagino	imɐʒino	imaZino	o
crédito	kɾedito	kredito	o
compras	kompɾɐʃ	kompraS	o
alerta	ɐlɛɾtɐ	alErta	o
pequenas	pɛkʷɛnɐʃ	pEkw~EnaS	o
sara	sɐɾɐ	sara	o
susan	suzɐ̃	suza*	o
abram	ɐbʁɐ̃	abXa*	o
enganado	ɛnɡɐnɐdo	Enganado	o
zangado	zɐnɡɐdo	zangado	o
importantes	impoɾtɐntɛʃ	importantES	o
jenny	ʒɛnnj	ZEnny	n
neve	nɛvɛ	nEvE	n
apanhado	ɐpɐnɐdo	apanado	o
pergunto	pɛɾɡnto	pErgnto	o
enganar	ɛnɡɐnɐɾ	Enganar	o
malas	mɐlɐʃ	malaS	o
investigar	invɛʃtiɡɐɾ	invEStigar	o
sexual	sɛksuɐl	sEksual	a
menor	mɛnoɾ	mEnor	o
falam	fɐlɐ̃	fala*	o
fechado	fɛkɐdo	fEkado	o
usando	uzɐndo	uzando	o
secreto	sɛkʁɛto	sEkXEto	o
joey	ʒowɛj	ZowEy	o
lixe	liksɛ	liksE	o
familiar	fɐmiliɐɾ	familiar	n
confio	konfio	konfio	o
fraco	fɾɐko	frako	o
protecção	pɾotɛksɐ̃w̃	protEksa*w*	o
saí	saj́	say	o
agarra	ɐɡɐʁɐ	agaXa	o
pânico	paniko	paniko	o
credo	kɾɛdo	krEdo	n
red	ʁɛd	XEd	n
esquisito	ɛʃkʷizito	ESkw~izito	o
relações	ʁɛlɐsʃ	XElasS	o
erros	ɛʁoʃ	EXoS	o
contei	kontɛj	kontEy	o
ha	ɐ	a	n
mande	mɐndɛ	mandE	n
guardar	ɡɐɾdɐɾ	gardar	o
fortes	foɾtɛʃ	fortES	v
serás	sɛɾaʃ	sEraS	o
domingo	dominɡo	domingo	n
caça	kɐsɐ	kasa	o
vejamos	vɛʒɐmoʃ	vEZamoS	o
queijo	kʷɛjʒo	kw~EyZo	o
preocupa	pɾɛokupɐ	prEokupa	o
adorava	ɐdoɾɐvɐ	adorava	o
bêbado	bebɐdo	bebado	o
aceito	ɐzɛjto	azEyto	o
carga	kɐɾɡɐ	karga	o
últimas	ultimɐʃ	ultimaS	o
irmos	iɾmoʃ	irmoS	o
entrega	ɛntɾɛɡɐ	EntrEga	o
dorme	doɾmɛ	dormE	o
apaixonado	ɐpajksonɐdo	apayksonado	o
perguntou	pɛɾɡntowu	pErgntowu	o
próximos	pɾɔksimoʃ	proksimoS	o
houver	owuvɛɾ	owuvEr	o
membro	mɛmbɾo	mEmbro	o
livrar	livʁɐɾ	livXar	o
julie	ʒuliɛ	ZuliE	o
recebeu	ʁɛzɛbew	XEzEbew	o
chloe	klowɛ	klowE	o
ponham	ponɐ̃	pona*	o
sexy	sɛksj	sEksy	a
deserto	dɛzɛɾto	dEzErto	o
golpe	ɡolpɛ	golpE	o
internet	intɛɾnɛt	intErnEt	n
útil	util	util	o
primeiros	pɾimɛjɾoʃ	primEyroS	o
cancro	kɐnkɾo	kankro	o
quiserem	kʷizɛɾɛ̃	kw~izErE*	o
carteira	kɐɾtɛjɾɐ	kartEyra	o
tento	tɛnto	tEnto	o
ficaram	fikɐɾɐ̃	fikara*	o
enfermeira	ɛnfɛɾmɛjɾɐ	EnfErmEyra	o
policial	poliziɐl	polizial	o
deixam	dɛjksɐ̃	dEyksa*	o
fila	filɐ	fila	n
convosco	konvoʃko	konvoSko	o
partiu	pɐɾtiw	partiw	o
passagem	pɐʃsɐʒɛ̃	paSsaZE*	o
carter	kɐɾtɛɾ	kartEr	n
adorar	ɐdoɾɐɾ	adorar	o
usado	uzɐdo	uzado	o
bravo	bɾɐvo	bravo	n
eh	ɛ	E	o
pão	pɐ̃w̃	pa*w*	o
afastar	ɐfɐʃtɐɾ	afaStar	o
ruim	ʁuj̃	Xuy*	o
mentiroso	mɛntiɾozo	mEntirozo	o
impressão	impɾɛʃsɐ̃w̃	imprESsa*w*	o
cheque	kɛkʷɛ	kEkw~E	n
enviou	ɛnviowu	Enviowu	o
revista	ʁɛviʃtɐ	XEviSta	o
nojento	noʒɛnto	noZEnto	o
lavar	lɐvɐɾ	lavar	o
génio	ʒenio	Zenio	o
smith	smit	smit	n
ajudou	ɐʒudowu	aZudowu	o
importância	impoɾtansiɐ	importansia	o
der	dɛɾ	dEr	s
victor	viktoɾ	viktor	n
retirar	ʁɛtiɾɐɾ	XEtirar	o
preparem	pɾɛpɐɾɛ̃	prEparE*	o
digamos	diɡɐmoʃ	digamoS	o
obra	obʁɐ	obXa	o
famílias	fɐmiliɐʃ	familiaS	o
usá	uza	uza	o
detalhes	dɛtɐlɛʃ	dEtalES	o
morrido	moʁido	moXido	o
bebidas	bɛbidɐʃ	bEbidaS	o
artigo	ɐɾtiɡo	artigo	o
dura	duɾɐ	dura	n
obter	obtɛɾ	obtEr	o
cem	sɛ̃	sE*	o
penses	pɛnsɛʃ	pEnsES	n
comportamento	kompoɾtɐmɛnto	komportamEnto	o
coma	komɐ	koma	n
tomates	tomɐtɛʃ	tomatES	o
famoso	fɐmozo	famozo	o
tentativa	tɛntɐtivɐ	tEntativa	o
maravilhosa	mɐɾɐvilozɐ	maraviloza	o
largue	lɐɾɡʷɛ	largw~E	o
condições	kondisʃ	kondisS	o
atravessar	ɐtʁɐvɛʃsɐɾ	atXavESsar	o
melhorar	mɛloɾɐɾ	mElorar	o
ferro	fɛʁo	fEXo	o
orgulhoso	oɾɡlozo	orglozo	o
francês	fɾɐnseʃ	franseS	o
especiais	ɛʃpɛziajʃ	ESpEziayS	o
continuo	kontinuo	kontinuo	n
show	sow	sow	n
lição	lisɐ̃w̃	lisa*w*	o
funeral	funɛɾɐl	funEral	n
trocar	tɾokɐɾ	trokar	o
tirá	tiɾa	tira	o
vazio	vɐzio	vazio	o
fizesse	fizɛʃsɛ	fizESsE	o
fita	fitɐ	fita	o
definitivamente	dɛfinitivɐmɛntɛ	dEfinitivamEntE	o
falso	fɐlso	falso	o
resultar	ʁɛzultɐɾ	XEzultar	o
sofrer	sofʁɛɾ	sofXEr	o
americana	ɐmɛɾikɐnɐ	amErikana	n
chegue	kɛɡʷɛ	kEgw~E	o
bolso	bolso	bolso	o
aprendi	ɐpʁɛndi	apXEndi	o
liceu	lizew	lizew	o
máquinas	makʷinɐʃ	makw~inaS	o
explica	ɛsplikɐ	Esplika	o
venda	vɛndɐ	vEnda	o
óculos	ɔkuloʃ	okuloS	o
fronteira	fɾontɛjɾɐ	frontEyra	o
compreender	kompɾɛɛndɛɾ	komprEEndEr	o
caraças	kɐɾɐsɐʃ	karasaS	o
canal	kɐnɐl	kanal	n
anjo	ɐnʒo	anZo	o
piscina	piʃsinɐ	piSsina	o
mesmos	mɛʃmoʃ	mESmoS	o
dom	dõ	do*	o
elevador	ɛlɛvɐdoɾ	ElEvador	o
reserva	ʁɛzɛɾvɐ	XEzErva	o
passeio	pɐʃsɛjo	paSsEyo	o
marshall	mɐɾsɐll	marsall	n
alice	ɐlizɛ	alizE	o
topo	topo	topo	o
duvido	duvido	duvido	o
net	nɛt	nEt	n
beijar	bɛjʒɐɾ	bEyZar	o
ouço	owuso	owuso	o
escadas	ɛʃkɐdɐʃ	ESkadaS	o
talento	tɐlɛnto	talEnto	o
defender	dɛfɛndɛɾ	dEfEndEr	n
honesto	onɛʃto	onESto	o
pensado	pɛnsɐdo	pEnsado	o
liguei	liɡʷɛj	ligw~Ey	o
cachorro	kɐkoʁo	kakoXo	o
rato	ʁɐto	Xato	o
pássaro	paʃsɐɾo	paSsaro	o
aldeia	ɐldɛjɐ	aldEya	o
chegamos	kɛɡɐmoʃ	kEgamoS	o
Chicago	kikɐɡo	kikago	n
lily	lilj	lily	n
parou	pɐɾowu	parowu	o
colegas	kolɛɡɐʃ	kolEgaS	o
impressionante	impɾɛʃsionɐntɛ	imprESsionantE	o
soa	sowɐ	sowa	o
esperamos	ɛʃpɛɾɐmoʃ	ESpEramoS	o
responda	ʁɛʃpondɐ	XESponda	o
cumprir	kumpɾiɾ	kumprir	o
enfrentar	ɛnfɾɛntɐɾ	EnfrEntar	o
motor	motoɾ	motor	n
admitir	ɐdmitiɾ	admitir	o
gajos	ɡɐʒoʃ	gaZoS	o
arriscar	ɐʁiʃkɐɾ	aXiSkar	o
entrevista	ɛntɾɛviʃtɐ	EntrEviSta	o
anti	ɐnti	anti	n
erva	ɛɾvɐ	Erva	o
macaco	mɐkɐko	makako	o
mostre	moʃtɾɛ	moStrE	o
tiros	tiɾoʃ	tiroS	n
aposta	ɐpoʃtɐ	apoSta	o
and	ɐnd	and	o
deveríamos	dɛvɛɾiɐmoʃ	dEvEriamoS	o
armário	ɐɾmaɾio	armario	o
dragão	dɾɐɡɐ̃w̃	draga*w*	o
fábrica	fabʁikɐ	fabXika	o
diário	diaɾio	diario	o
social	soziɐl	sozial	n
sarilhos	sɐɾiloʃ	sariloS	o
corda	koɾdɐ	korda	o
hipóteses	ipɔtɛzɛʃ	ipotEzES	o
mentiras	mɛntiɾɐʃ	mEntiraS	o
discurso	diʃkuɾso	diSkurso	o
correio	koʁɛjo	koXEyo	o
morada	moɾɐdɐ	morada	o
casal	kɐzɐl	kazal	o
amas	ɐmɐʃ	amaS	o
continuem	kontinuɛ̃	kontinuE*	o
perdeste	pɛɾdɛʃtɛ	pErdEStE	o
amigas	ɐmiɡɐʃ	amigaS	o
achamos	ɐkɐmoʃ	akamoS	o
chamadas	kɐmɐdɐʃ	kamadaS	o
superior	supɛɾioɾ	supErior	n
Amy	ɐmj	amy	o
Lucy	luzj	luzy	n
imagens	imɐʒɛnʃ	imaZEnS	o
jornais	ʒoɾnajʃ	ZornayS	o
afaste	ɐfɐʃtɛ	afaStE	o
parado	pɐɾɐdo	parado	o
vermelha	vɛɾmɛlɐ	vErmEla	o
faltam	fɐltɐ̃	falta*	o
acordado	ɐkoɾdɐdo	akordado	o
armadilha	ɐɾmɐdilɐ	armadila	o
voltamos	voltɐmoʃ	voltamoS	o
virá	viɾa	vira	o
garanto	ɡɐɾɐnto	garanto	o
começaram	komɛsɐɾɐ̃	komEsara*	o
página	paʒinɐ	paZina	o
ensinou	ɛnsinowu	Ensinowu	o
terminou	tɛɾminowu	tErminowu	o
peguei	pɛɡʷɛj	pEgw~Ey	o
brincando	bɾinkɐndo	brinkando	o
humanidade	umɐnidɐdɛ	umanidadE	o
Lois	lowiʃ	lowiS	o
quadro	kɐdʁo	kadXo	o
ladrão	lɐdʁɐ̃w̃	ladXa*w*	o
violência	violensiɐ	violensia	o
parvo	pɐɾvo	parvo	n
testemunhas	tɛʃtɛmunɐʃ	tEStEmunaS	o
nasceu	nɐʃsew	naSsew	o
comprou	kompɾowu	komprowu	o
sozinhos	sozinoʃ	sozinoS	o
mantenham	mɐntɛnɐ̃	mantEna*	o
permissão	pɛɾmiʃsɐ̃w̃	pErmiSsa*w*	o
mundial	mundiɐl	mundial	o
consciência	konsiensiɐ	konsiensia	o
assinar	ɐʃsinɐɾ	aSsinar	o
judeus	ʒudewʃ	ZudewS	o
carregar	kɐʁɛɡɐɾ	kaXEgar	o
rápida	ʁapidɐ	Xapida	o
Europa	ewɾopɐ	ewropa	n
pesadelo	pɛzɐdɛlo	pEzadElo	o
bateu	bɐtew	batew	o
deixas	dɛjksɐʃ	dEyksaS	o
despedir	dɛʃpɛdiɾ	dESpEdir	o
Jackson	ʒɐkksõ	Zakkso*	n
gasolina	ɡɐzolinɐ	gazolina	o
olhando	olɐndo	olando	o
Kelly	kɛllj	kElly	n
incêndio	insendio	insendio	o
prémio	pɾemio	premio	o
santa	sɐntɐ	santa	n
peças	pɛsɐʃ	pEsaS	o
fiques	fikʷɛʃ	fikw~ES	o
divisão	divizɐ̃w̃	diviza*w*	o
pensaste	pɛnsɐʃtɛ	pEnsaStE	o
gostou	ɡoʃtowu	goStowu	o
postos	poʃtoʃ	poStoS	o
sigam	siɡɐ̃	siga*	o
federal	fɛdɛɾɐl	fEdEral	n
legendas	lɛʒɛndɐʃ	lEZEndaS	o
directo	diɾɛkto	dirEkto	o
chamava	kɐmɐvɐ	kamava	o
proposta	pɾopoʃtɐ	propoSta	o
impressões	impɾɛʃsʃ	imprESsS	o
bond	bond	bond	n
século	sekulo	sekulo	o
experimentar	ɛspɛɾimɛntɐɾ	EspErimEntar	o
milagre	milɐɡʁɛ	milagXE	o
calmo	kɐlmo	kalmo	o
siga	siɡɐ	siga	o
temo	tɛmo	tEmo	o
puto	puto	puto	o
odeia	odɛjɐ	odEya	o
choque	kokʷɛ	kokw~E	o
devolver	dɛvolvɛɾ	dEvolvEr	o
decidiu	dɛzidiw	dEzidiw	o
grace	ɡɾɐzɛ	grazE	n
vivem	vivɛ̃	vivE*	o
ganhei	ɡɐnɛj	ganEy	o
particular	pɐɾtikulɐɾ	partikular	n
conosco	konoʃko	konoSko	o
esqueças	ɛʃkʷɛsɐʃ	ESkw~EsaS	o
salva	sɐlvɐ	salva	o
trabalhava	tɾɐbɐlɐvɐ	trabalava	o
cansada	kɐnsɐdɐ	kansada	o
completa	komplɛtɐ	komplEta	o
bombas	bombɐʃ	bombaS	o
maricas	mɐɾikɐʃ	marikaS	o
howard	owɐɾd	oward	n
iguais	iɡajʃ	igayS	o
ficado	fikɐdo	fikado	o
atira	ɐtiɾɐ	atira	o
roubo	ʁowubo	Xowubo	o
libertar	libɛɾtɐɾ	libErtar	o
necessidade	nɛzɛʃsidɐdɛ	nEzESsidadE	o
sede	sɛdɛ	sEdE	o
assassinos	ɐʃsɐʃsinoʃ	aSsaSsinoS	o
crimes	kɾimɛʃ	krimES	n
alemães	ɐlɛmɐ̃j̃ʃ	alEma*y*S	o
harvey	ɐɾvɛj	arvEy	n
directamente	diɾɛktɐmɛntɛ	dirEktamEntE	o
suficientemente	sufiziɛntɛmɛntɛ	sufiziEntEmEntE	o
estômago	ɛʃtomɐɡo	EStomago	o
identificação	idɛntifikɐsɐ̃w̃	idEntifikasa*w*	o
possam	poʃsɐ̃	poSsa*	o
gelado	ʒɛlɐdo	ZElado	o
tripulação	tɾipulɐsɐ̃w̃	tripulasa*w*	o
percebeste	pɛɾsɛbɛʃtɛ	pErsEbEStE	o
quartos	kɐɾtoʃ	kartoS	n
envolvido	ɛnvolvido	Envolvido	o
canto	kɐnto	kanto	n
sentia	sɛntiɐ	sEntia	o
pô	po	po	o
escondido	ɛʃkondido	ESkondido	o
localização	lokɐlizɐsɐ̃w̃	lokalizasa*w*	o
fumo	fumo	fumo	o
estarão	ɛʃtɐɾɐ̃w̃	EStara*w*	o
alarme	ɐlɐɾmɛ	alarmE	o
procuro	pɾokuɾo	prokuro	o
levei	lɛvɛj	lEvEy	o
fantástica	fɐntaʃtikɐ	fantaStika	o
disposto	diʃpoʃto	diSpoSto	o
bilhetes	bilɛtɛʃ	bilEtES	o
inútil	inutil	inutil	o
marcas	mɐɾkɐʃ	markaS	o
pó	pɔ	po	o
palco	pɐlko	palko	o
bando	bɐndo	bando	o
solo	solo	solo	n
assustador	ɐʃsuʃtɐdoɾ	aSsuStador	o
aceita	ɐzɛjtɐ	azEyta	o
roger	ʁoʒɛɾ	XoZEr	o
mexas	mɛksɐʃ	mEksaS	o
negros	nɛɡʁoʃ	nEgXoS	n
fase	fɐzɛ	fazE	o
garotas	ɡɐɾotɐʃ	garotaS	o
certas	sɛɾtɐʃ	sErtaS	o
imagina	imɐʒinɐ	imaZina	o
urso	uɾso	urso	o
mínimo	minimo	minimo	o
olhada	olɐdɐ	olada	o
jeff	ʒɛff	ZEff	o
miami	miɐmi	miami	n
tirei	tiɾɛj	tirEy	o
cabeças	kɐbɛsɐʃ	kabEsaS	o
intenção	intɛnsɐ̃w̃	intEnsa*w*	o
suicídio	sujzidio	suyzidio	o
possibilidade	poʃsibilidɐdɛ	poSsibilidadE	o
vigilância	viʒilansiɐ	viZilansia	o
city	sitj	sity	n
poderíamos	podɛɾiɐmoʃ	podEriamoS	o
puxa	puksɐ	puksa	o
queda	kʷɛdɐ	kw~Eda	o
imperador	impɛɾɐdoɾ	impErador	o
matem	mɐtɛ̃	matE*	o
cego	sɛɡo	sEgo	o
entrei	ɛntɾɛj	EntrEy	o
convidado	konvidɐdo	konvidado	o
ficava	fikɐvɐ	fikava	o
montanhas	montɐnɐʃ	montanaS	o
original	oɾiʒinɐl	oriZinal	n
trabalhos	tɾɐbɐloʃ	trabaloS	o
entretanto	ɛntɾɛtɐnto	EntrEtanto	o
trabalhando	tɾɐbɐlɐndo	trabalando	o
sombra	sombɾɐ	sombra	o
humor	umoɾ	umor	n
sabiam	sɐbiɐ̃	sabia*	o
taylor	tɐjloɾ	taylor	n
agência	ɐʒensiɐ	aZensia	o
vidro	vidʁo	vidXo	o
presentes	pɾɛzɛntɛʃ	prEzEntES	v
saio	sɐjo	sayo	o
gigante	ʒiɡɐntɛ	ZigantE	o
traseiro	tɾɐzɛjɾo	trazEyro	o
combinado	kombinɐdo	kombinado	o
sofá	sofa	sofa	o
russo	ʁuʃso	XuSso	o
botão	botɐ̃w̃	bota*w*	o
dando	dɐndo	dando	o
paredes	pɐɾɛdɛʃ	parEdES	v
assustado	ɐʃsuʃtɐdo	aSsuStado	o
levado	lɛvɐdo	lEvado	o
ires	iɾɛʃ	irES	n
secreta	sɛkʁɛtɐ	sEkXEta	o
pergunte	pɛɾɡntɛ	pErgntE	o
castelo	kɐʃtɛlo	kaStElo	o
virgem	viɾʒɛ̃	virZE*	o
atender	ɐtɛndɛɾ	atEndEr	o
causar	kawzɐɾ	kawzar	o
garganta	ɡɐɾɡɐntɐ	garganta	o
teatro	tɛɐtʁo	tEatXo	o
locais	lokajʃ	lokayS	o
moda	modɐ	moda	o
diversão	divɛɾsɐ̃w̃	divErsa*w*	o
robin	ʁobĩ	Xobi*	n
annie	ɐnniɛ	anniE	o
espelho	ɛʃpɛlo	ESpElo	o
galinha	ɡɐlinɐ	galina	o
ilegal	ilɛɡɐl	ilEgal	o
pedras	pɛdʁɐʃ	pEdXaS	o
estivemos	ɛʃtivɛmoʃ	EStivEmoS	o
repetir	ʁɛpɛtiɾ	XEpEtir	o
consiga	konsiɡɐ	konsiga	o
possas	poʃsɐʃ	poSsaS	o
stan	stɐ̃	sta*	o
roubado	ʁowubɐdo	Xowubado	o
estragar	ɛʃtɾɐɡɐɾ	EStragar	o
alternativa	ɐltɛɾnɐtivɐ	altErnativa	o
perante	pɛɾɐntɛ	pErantE	o
usam	uzɐ̃	uza*	o
pareço	pɐɾɛso	parEso	o
tim	tĩ	ti*	o
falha	fɐlɐ	fala	o
assustar	ɐʃsuʃtɐɾ	aSsuStar	o
compra	kompɾɐ	kompra	o
cigarro	siɡɐʁo	sigaXo	o
relaxa	ʁɛlɐksɐ	XElaksa	o
acampamento	ɐkɐmpɐmɛnto	akampamEnto	o
coloque	kolokʷɛ	kolokw~E	o
câmaras	kamɐɾɐʃ	kamaraS	o
jesse	ʒɛʃsɛ	ZESsE	o
partam	pɐɾtɐ̃	parta*	o
lados	lɐdoʃ	ladoS	o
dores	doɾɛʃ	dorES	o
adivinhar	ɐdivinɐɾ	adivinar	o
abrigo	ɐbʁiɡo	abXigo	o
ferida	fɛɾidɐ	fErida	o
tropas	tɾopɐʃ	tropaS	o
estiveres	ɛʃtivɛɾɛʃ	EStivErES	o
estranhos	ɛʃtɾɐnoʃ	EStranoS	o
you	jowu	yowu	o
leis	lɛjʃ	lEyS	n
rick	ʁikk	Xikk	n
mora	moɾɐ	mora	o
negativo	nɛɡɐtivo	nEgativo	o
huh	u	u	o
ambulância	ɐmbulansiɐ	ambulansia	o
pistola	piʃtolɐ	piStola	o
pensamentos	pɛnsɐmɛntoʃ	pEnsamEntoS	o
mensagens	mɛnsɐʒɛnʃ	mEnsaZEnS	o
cópia	kɔpiɐ	kopia	o
saímos	saj́moʃ	saymoS	o
encontre	ɛnkontɾɛ	EnkontrE	o
brancos	bɾɐnkoʃ	brankoS	o
incluindo	inklujndo	inkluyndo	o
haveria	ɐvɛɾiɐ	avEria	o
portão	poɾtɐ̃w̃	porta*w*	o
corrente	koʁɛntɛ	koXEntE	o
transporte	tɾɐnspoɾtɛ	transportE	o
saibas	sajbɐʃ	saybaS	o
vindas	vindɐʃ	vindaS	o
areia	ɐɾɛjɐ	arEya	o
permitir	pɛɾmitiɾ	pErmitir	o
disco	diʃko	diSko	n
pacientes	pɐziɛntɛʃ	paziEntES	o
mandado	mɐndɐdo	mandado	o
chegámos	kɛɡamoʃ	kEgamoS	o
feitos	fɛjtoʃ	fEytoS	o
terry	tɛʁj	tEXy	n
fechada	fɛkɐdɐ	fEkada	o
capacidade	kɐpɐzidɐdɛ	kapazidadE	o
papéis	pɐpɛjʃ	papEyS	o
bruce	bɾuzɛ	bruzE	n
escolheu	ɛʃkolew	ESkolew	o
conheceu	konɛzew	konEzew	o
recentemente	ʁɛzɛntɛmɛntɛ	XEzEntEmEntE	o
desliga	dɛʃliɡɐ	dESliga	o
documentos	dokumɛntoʃ	dokumEntoS	o
maluca	mɐlukɐ	maluka	o
veremos	vɛɾɛmoʃ	vErEmoS	o
acções	ɐksʃ	aksS	o
trago	tɾɐɡo	trago	o
tomou	tomowu	tomowu	o
barry	bɐʁj	baXy	o
jogador	ʒoɡɐdoɾ	Zogador	o
acabámos	ɐkɐbamoʃ	akabamoS	o
garantir	ɡɐɾɐntiɾ	garantir	o
comunidade	komunidɐdɛ	komunidadE	o
crise	kɾizɛ	krizE	o
operações	opɛɾɐsʃ	opErasS	o
roy	ʁowj	Xowy	o
texas	tɛksɐʃ	tEksaS	n
sobe	sobɛ	sobE	o
metro	mɛtʁo	mEtXo	n
digitais	diʒitajʃ	diZitayS	o
livres	livʁɛʃ	livXES	o
raça	ʁɐsɐ	Xasa	o
joelhos	ʒowɛloʃ	ZowEloS	o
registos	ʁɛʒiʃtoʃ	XEZiStoS	o
começamos	komɛsɐmoʃ	komEsamoS	o
nadar	nɐdɐɾ	nadar	o
cela	sɛlɐ	sEla	o
vince	vinsɛ	vinsE	o
aviões	ɐviʃ	aviS	o
wilson	wilsõ	wilso*	n
madame	mɐdɐmɛ	madamE	n
falaste	fɐlɐʃtɛ	falaStE	o
karen	kɐɾɛ̃	karE*	n
sabendo	sɐbɛndo	sabEndo	o
ocupada	okupɐdɐ	okupada	o
segurar	sɛɡʁɐɾ	sEgXar	o
francisco	fɾɐnsiʃko	fransiSko	o
continuas	kontinuɐʃ	kontinuaS	o
comece	komɛzɛ	komEzE	o
alan	ɐlɐ̃	ala*	o
vires	viɾɛʃ	virES	o
vice	vizɛ	vizE	n
cura	kuɾɐ	kura	o
vaca	vɐkɐ	vaka	o
felicidade	fɛlizidɐdɛ	fElizidadE	o
professora	pɾofɛʃsoɾɐ	profESsora	o
tarefa	tɐɾɛfɐ	tarEfa	o
sorriso	soʁizo	soXizo	o
desaparecido	dɛzɐpɐɾɛzido	dEzaparEzido	o
convencer	konvɛnsɛɾ	konvEnsEr	o
atirou	ɐtiɾowu	atirowu	o
danos	dɐnoʃ	danoS	o
china	kinɐ	kina	n
segui	sɛɡʷi	sEgw~i	o
trouxeste	tɾowuksɛʃtɛ	trowuksEStE	o
apostar	ɐpoʃtɐɾ	apoStar	o
greg	ɡɾɛɡ	grEg	o
feio	fɛjo	fEyo	o
formas	foɾmɐʃ	formaS	o
tyler	tjlɛɾ	tylEr	n
ponta	pontɐ	ponta	o
madeira	mɐdɛjɾɐ	madEyra	n
máscara	maʃkɐɾɐ	maSkara	o
engano	ɛnɡɐno	Engano	o
artista	ɐɾtiʃtɐ	artiSta	o
alunos	ɐlunoʃ	alunoS	o
pus	puʃ	puS	n
judeu	ʒudew	Zudew	o
wayne	wɐjnɛ	waynE	n
alcance	ɐlkɐnsɛ	alkansE	o
acabamos	ɐkɐbɐmoʃ	akabamoS	o
privado	pɾivɐdo	privado	o
paciência	pɐziensiɐ	paziensia	o
diamantes	diɐmɐntɛʃ	diamantES	n
acabo	ɐkɐbo	akabo	o
amizade	ɐmizɐdɛ	amizadE	o
estares	ɛʃtɐɾɛʃ	EStarES	o
acalmar	ɐkɐlmɐɾ	akalmar	o
calado	kɐlɐdo	kalado	o
convidados	konvidɐdoʃ	konvidadoS	o
coincidência	kowinsidensiɐ	kowinsidensia	o
Edward	ɛdwɐɾd	Edward	n
esqueceu	ɛʃkʷɛzew	ESkw~Ezew	o
basicamente	bɐzikɐmɛntɛ	bazikamEntE	o
respira	ʁɛʃpiɾɐ	XESpira	o
festas	fɛʃtɐʃ	fEStaS	o
daquelas	dɐkʷɛlɐʃ	dakw~ElaS	o
cavaleiro	kɐvɐlɛjɾo	kavalEyro	o
milhas	milɐʃ	milaS	o
nação	nɐsɐ̃w̃	nasa*w*	o
atingido	ɐtinʒido	atinZido	o
limite	limitɛ	limitE	o
álcool	alkowol	alkowol	o
ambiente	ɐmbiɛntɛ	ambiEntE	o
criatura	kɾiɐtuɾɐ	kriatura	o
palhaço	pɐlɐso	palaso	o
atitude	ɐtitudɛ	atitudE	o
túnel	tunɛl	tunEl	o
hein	ɛj̃	Ey*	o
identidade	idɛntidɐdɛ	idEntidadE	o
rose	ʁozɛ	XozE	n
garagem	ɡɐɾɐʒɛ̃	garaZE*	o
chateado	kɐtɛɐdo	katEado	o
achava	ɐkɐvɐ	akava	o
alemão	ɐlɛmɐ̃w̃	alEma*w*	o
prepara	pɾɛpɐɾɐ	prEpara	o
antigos	ɐntiɡoʃ	antigoS	o
pensamos	pɛnsɐmoʃ	pEnsamoS	o
quarta	kɐɾtɐ	karta	o
seguros	sɛɡʁoʃ	sEgXoS	o
colocou	kolokowu	kolokowu	o
mamas	mɐmɐʃ	mamaS	n
tomei	tomɛj	tomEy	o
prisioneiros	pɾizionɛjɾoʃ	prizionEyroS	o
marty	mɐɾtj	marty	o
sinceramente	sinsɛɾɐmɛntɛ	sinsEramEntE	o
nâo	nao	nao	o
terroristas	tɛʁoɾiʃtɐʃ	tEXoriStaS	o
explicação	ɛsplikɐsɐ̃w̃	Esplikasa*w*	o
cai	kaj	kay	o
aguento	ɐɡʷɛnto	agw~Ento	o
hum	ũ	u*	n
aumentar	awmɛntɐɾ	awmEntar	o
prometi	pɾomɛti	promEti	o
sistemas	siʃtɛmɐʃ	siStEmaS	o
confuso	konfuzo	konfuzo	o
russos	ʁuʃsoʃ	XuSsoS	o
sós	sɔʃ	soS	o
pizza	piʒzɐ	piZza	n
casada	kɐzɐdɐ	kazada	o
use	uzɛ	uzE	n
museu	muzew	muzew	o
frota	fɾotɐ	frota	o
biblioteca	bibliotɛkɐ	bibliotEka	o
sono	sono	sono	o
regresso	ʁɛɡʁɛʃso	XEgXESso	o
desastre	dɛzɐʃtɾɛ	dEzaStrE	o
atraso	ɐtʁɐzo	atXazo	o
difíceis	difizɛjʃ	difizEyS	o
daquilo	dɐkʷilo	dakw~ilo	o
abandonar	ɐbɐndonɐɾ	abandonar	o
tratado	tɾɐtɐdo	tratado	o
fantasmas	fɐntɐʃmɐʃ	fantaSmaS	o
desafio	dɛzɐfio	dEzafio	o
firme	fiɾmɛ	firmE	o
sal	sɐl	sal	o
Marcus	mɐɾkuʃ	markuS	o
treinar	tɾɛjnɐɾ	trEynar	o
inacreditável	inɐkʁɛditavɛl	inakXEditavEl	o
naves	nɐvɛʃ	navES	n
linhas	linɐʃ	linaS	o
oceano	ozɛɐno	ozEano	o
demora	dɛmoɾɐ	dEmora	o
fores	foɾɛʃ	forES	n
Jean	ʒɛɐ̃	ZEa*	n
graus	ɡɾawʃ	grawS	o
unidades	unidɐdɛʃ	unidadES	o
tesouro	tɛzowuɾo	tEzowuro	o
maravilha	mɐɾɐvilɐ	maravila	o
mac	mɐk	mak	n
hank	ɐnk	ank	n
mando	mɐndo	mando	o
passamos	pɐʃsɐmoʃ	paSsamoS	o
tiveres	tivɛɾɛʃ	tivErES	o
acreditam	ɐkʁɛditɐ̃	akXEdita*	o
derek	dɛɾɛk	dErEk	o
vencedor	vɛnsɛdoɾ	vEnsEdor	o
escrevi	ɛʃkɾɛvi	ESkrEvi	o
estiveram	ɛʃtivɛɾɐ̃	EStivEra*	o
toques	tokʷɛʃ	tokw~ES	n
passam	pɐʃsɐ̃	paSsa*	o
oficiais	ofiziajʃ	ofiziayS	o
promessa	pɾomɛʃsɐ	promESsa	o
sugiro	suʒiɾo	suZiro	o
hitler	itlɛɾ	itlEr	n
damos	dɐmoʃ	damoS	o
permite	pɛɾmitɛ	pErmitE	o
veículo	vɛj́kulo	vEykulo	o
repito	ʁɛpito	XEpito	o
escreve	ɛʃkɾɛvɛ	ESkrEvE	o
espectacular	ɛʃpɛktɐkulɐɾ	ESpEktakular	o
adorável	ɐdoɾavɛl	adoravEl	o
ricos	ʁikoʃ	XikoS	n
apanhá	ɐpɐna	apana	o
voltarei	voltɐɾɛj	voltarEy	o
jogada	ʒoɡɐdɐ	Zogada	o
nuclear	nuklɛɐɾ	nuklEar	a
perdoe	pɛɾdowɛ	pErdowE	o
arranjaste	ɐʁɐnʒɐʃtɛ	aXanZaStE	o
encontramo	ɛnkontɾɐmo	Enkontramo	o
carlos	kɐɾloʃ	karloS	n
superfície	supɛɾfiziɛ	supErfiziE	o
conseguiram	konsɛɡʷiɾɐ̃	konsEgw~ira*	o
selvagem	sɛlvɐʒɛ̃	sElvaZE*	o
motorista	motoɾiʃtɐ	motoriSta	o
kim	kĩ	ki*	o
falava	fɐlɐvɐ	falava	o
atirador	ɐtiɾɐdoɾ	atirador	o
guia	ɡʷiɐ	gw~ia	o
prisioneiro	pɾizionɛjɾo	prizionEyro	o
tenhamos	tɛnɐmoʃ	tEnamoS	o
esquadra	ɛʃkɐdʁɐ	ESkadXa	o
transformar	tɾɐnsfoɾmɐɾ	transformar	o
seremos	sɛɾɛmoʃ	sErEmoS	o
inverno	invɛɾno	invErno	o
dirigir	diɾiʒiɾ	diriZir	o
katie	kɐtiɛ	katiE	o
josh	ʒoʃ	ZoS	v
educação	ɛdukɐsɐ̃w̃	Edukasa*w*	o
mantê	mɐnte	mante	o
mistério	miʃteɾio	miSterio	o
sopa	sopɐ	sopa	o
inteligência	intɛliʒensiɐ	intEliZensia	o
partilhar	pɐɾtilɐɾ	partilar	o
andrew	ɐndɾɛw	andrEw	n
criou	kɾiowu	kriowu	o
vizinhos	vizinoʃ	vizinoS	o
sangrar	sɐnɡɾɐɾ	sangrar	o
batatas	bɐtɐtɐʃ	batataS	o
versão	vɛɾsɐ̃w̃	vErsa*w*	o
dispara	diʃpɐɾɐ	diSpara	o
facilmente	fɐzilmɛntɛ	fazilmEntE	o
criminoso	kɾiminozo	kriminozo	o
criado	kɾiɐdo	kriado	o
fundos	fundoʃ	fundoS	o
glória	ɡlɔɾiɐ	gloria	o
confirmar	konfiɾmɐɾ	konfirmar	o
alegria	ɐlɛɡʁiɐ	alEgXia	o
legendagem	lɛʒɛndɐʒɛ̃	lEZEndaZE*	o
autoridade	awtoɾidɐdɛ	awtoridadE	o
confortável	konfoɾtavɛl	konfortavEl	o
ganho	ɡɐno	gano	o
claramente	klɐɾɐmɛntɛ	klaramEntE	o
noivo	nowivo	nowivo	o
adn	ɐd	ad	o
passos	pɐʃsoʃ	paSsoS	o
nascer	nɐʃsɛɾ	naSsEr	o
registo	ʁɛʒiʃto	XEZiSto	o
provável	pɾovavɛl	provavEl	o
amante	ɐmɐntɛ	amantE	o
cavalheiro	kɐvɐlɛjɾo	kavalEyro	o
juntas	ʒuntɐʃ	ZuntaS	n
escuridão	ɛʃkuɾidɐ̃w̃	ESkurida*w*	o
arranjou	ɐʁɐnʒowu	aXanZowu	o
despedido	dɛʃpɛdido	dESpEdido	o
sofrimento	sofʁimɛnto	sofXimEnto	o
fales	fɐlɛʃ	falES	o
irmãs	iɾmɐ̃ʃ	irma*S	o
poderiam	podɛɾiɐ̃	podEria*	o
praticamente	pɾɐtikɐmɛntɛ	pratikamEntE	o
prenda	pɾɛndɐ	prEnda	o
champanhe	kɐmpɐnɛ	kampanE	o
doug	dowuɡ	dowug	o
acompanhar	ɐkompɐnɐɾ	akompanar	o
senhorita	sɛnoɾitɐ	sEnorita	o
largar	lɐɾɡɐɾ	largar	o
virem	viɾɛ̃	virE*	o
período	pɛɾiodo	pEriodo	o
ficarei	fikɐɾɛj	fikarEy	o
padrão	pɐdʁɐ̃w̃	padXa*w*	o
levam	lɛvɐ̃	lEva*	o
jackie	ʒɐkkiɛ	ZakkiE	o
vantagem	vɐntɐʒɛ̃	vantaZE*	o
destruição	dɛʃtɾujsɐ̃w̃	dEStruysa*w*	o
ambas	ɐmbɐʃ	ambaS	o
assistir	ɐʃsiʃtiɾ	aSsiStir	o
lenda	lɛndɐ	lEnda	o
mudei	mudɛj	mudEy	o
ja	ʒɐ	Za	o
seca	sɛkɐ	sEka	o
elizabeth	ɛlizɐbɛt	ElizabEt	n
preferia	pɾɛfɛɾiɐ	prEfEria	o
áfrica	afʁikɐ	afXika	o
combustível	kombuʃtivɛl	kombuStivEl	o
pensamento	pɛnsɐmɛnto	pEnsamEnto	o
pagou	pɐɡowu	pagowu	o
lábios	labioʃ	labioS	o
esquina	ɛʃkʷinɐ	ESkw~ina	o
gentil	ʒɛntil	ZEntil	o
cinto	sinto	sinto	o
apresento	ɐpʁɛzɛnto	apXEzEnto	o
caixas	kajksɐʃ	kayksaS	o
botas	botɐʃ	botaS	n
chato	kɐto	kato	o
almoçar	ɐlmosɐɾ	almosar	o
tivessem	tivɛʃsɛ̃	tivESsE*	o
vire	viɾɛ	virE	o
burro	buʁo	buXo	n
recado	ʁɛkɐdo	XEkado	o
próprias	pɾɔpʁiɐʃ	propXiaS	o
street	stɾɛɛt	strEEt	n
instruções	instɾusʃ	instrusS	o
bruxa	bɾuksɐ	bruksa	o
advogados	ɐdvoɡɐdoʃ	advogadoS	o
medicina	mɛdizinɐ	mEdizina	o
incomodar	inkomodɐɾ	inkomodar	o
dúvidas	duvidɐʃ	duvidaS	o
chegarmos	kɛɡɐɾmoʃ	kEgarmoS	o
louis	lowujʃ	lowuyS	n
forem	foɾɛ̃	forE*	o
açúcar	ɐsukɐɾ	asukar	o
mortes	moɾtɛʃ	mortES	o
vivemos	vivɛmoʃ	vivEmoS	o
doc	dok	dok	n
perde	pɛɾdɛ	pErdE	o
marcar	mɐɾkɐɾ	markar	o
cole	kolɛ	kolE	n
doentes	dowɛntɛʃ	dowEntES	o
percebeu	pɛɾsɛbew	pErsEbew	o
marinha	mɐɾinɐ	marina	o
acalme	ɐkɐlmɛ	akalmE	o
veneno	vɛnɛno	vEnEno	o
cave	kɐvɛ	kavE	n
mina	minɐ	mina	n
pau	paw	paw	o
caçar	kɐsɐɾ	kasar	o
preparados	pɾɛpɐɾɐdoʃ	prEparadoS	o
discussão	diʃkuʃsɐ̃w̃	diSkuSsa*w*	o
meteu	mɛtew	mEtew	o
demónio	dɛmɔnio	dEmonio	o
aproxima	ɐpʁoksimɐ	apXoksima	o
maneiras	mɐnɛjɾɐʃ	manEyraS	o
cobra	kobʁɐ	kobXa	n
malditos	mɐlditoʃ	malditoS	o
daria	dɐɾiɐ	daria	o
fio	fio	fio	o
trazê	tɾɐze	traze	o
empregado	ɛmpɾɛɡɐdo	EmprEgado	o
paraíso	pɐɾaj́zo	parayzo	o
pedaços	pɛdɐsoʃ	pEdasoS	o
montes	montɛʃ	montES	n
terreno	tɛʁɛno	tEXEno	o
lançamento	lɐnsɐmɛnto	lansamEnto	o
ficaste	fikɐʃtɛ	fikaStE	o
arranjo	ɐʁɐnʒo	aXanZo	o
presumo	pɾɛzumo	prEzumo	o
acto	ɐkto	akto	o
pobres	pobʁɛʃ	pobXES	o
trinta	tɾintɐ	trinta	o
papa	pɐpɐ	papa	n
noutro	nowutʁo	nowutXo	o
mágico	maʒiko	maZiko	o
qualidade	kɐlidɐdɛ	kalidadE	o
of	of	of	o
medida	mɛdidɐ	mEdida	o
pré	pɾe	pre	o
johnson	ʒonsõ	Zonso*	n
maggie	mɐɡʒiɛ	magZiE	o
pulso	pulso	pulso	o
satélite	sɐtelitɛ	satelitE	o
negociar	nɛɡoziɐɾ	nEgoziar	o
quebrar	kʷɛbʁɐɾ	kw~EbXar	o
chegaste	kɛɡɐʃtɛ	kEgaStE	o
osso	oʃso	oSso	o
adoraria	ɐdoɾɐɾiɐ	adoraria	o
cobertura	kobɛɾtuɾɐ	kobErtura	o
telefonema	tɛlɛfonɛmɐ	tElEfonEma	o
morrem	moʁɛ̃	moXE*	o
sujo	suʒo	suZo	o
sujeito	suʒɛjto	suZEyto	o
leonard	lɛonɐɾd	lEonard	n
capazes	kɐpɐzɛʃ	kapazES	o
comissão	komiʃsɐ̃w̃	komiSsa*w*	o
guerreiro	ɡʷɛʁɛjɾo	gw~EXEyro	o
okay	okɐj	okay	n
saudável	sawdavɛl	sawdavEl	o
fria	fɾiɐ	fria	o
joga	ʒoɡɐ	Zoga	o
armado	ɐɾmɐdo	armado	o
onda	ondɐ	onda	o
dissesse	diʃsɛʃsɛ	diSsESsE	o
velhote	vɛlotɛ	vElotE	o
patrick	pɐtʁikk	patXikk	n
esforço	ɛʃfoɾso	ESforso	o
comeu	komew	komew	o
contato	kontɐto	kontato	o
prato	pɾɐto	prato	o
queríamos	kʷɛɾiɐmoʃ	kw~EriamoS	o
coloca	kolokɐ	koloka	o
falámos	fɐlamoʃ	falamoS	o
normais	noɾmajʃ	normayS	o
aérea	ɐeɾɛɐ	aerEa	o
alimentar	ɐlimɛntɐɾ	alimEntar	o
ritmo	ʁitmo	Xitmo	o
estacionamento	ɛʃtɐzionɐmɛnto	EStazionamEnto	o
divórcio	divɔɾsio	divorsio	o
neles	nɛlɛʃ	nElES	o
lorde	loɾdɛ	lordE	o
cruel	kɾuɛl	kruEl	s
temperatura	tɛmpɛɾɐtuɾɐ	tEmpEratura	o
aliás	ɐliaʃ	aliaS	o
leo	lɛo	lEo	n
gira	ʒiɾɐ	Zira	o
piores	pioɾɛʃ	piorES	o
ouvindo	owuvindo	owuvindo	o
chamamos	kɐmɐmoʃ	kamamoS	o
brown	bɾow	brow	n
cozinhar	kozinɐɾ	kozinar	o
extremamente	ɛstɾɛmɐmɛntɛ	EstrEmamEntE	o
abriu	ɐbʁiw	abXiw	o
esquecido	ɛʃkʷɛzido	ESkw~Ezido	o
significado	siɡnifikɐdo	signifikado	o
deva	dɛvɐ	dEva	o
adivinha	ɐdivinɐ	adivina	o
asas	ɐzɐʃ	azaS	o
concentrar	konsɛntɾɐɾ	konsEntrar	o
potter	pottɛɾ	pottEr	n
homer	omɛɾ	omEr	n
matam	mɐtɐ̃	mata*	o
governador	ɡovɛɾnɐdoɾ	govErnador	o
ficando	fikɐndo	fikando	o
limites	limitɛʃ	limitES	v
parker	pɐɾkɛɾ	parkEr	n
gerente	ʒɛɾɛntɛ	ZErEntE	o
dama	dɐmɐ	dama	n
us	uʃ	uS	n
porém	poɾẽ	pore*	o
saído	saj́do	saydo	o
rota	ʁotɐ	Xota	n
decisões	dɛzisʃ	dEzisS	o
cuida	kujdɐ	kuyda	o
visitas	vizitɐʃ	vizitaS	o
janelas	ʒɐnɛlɐʃ	ZanElaS	o
criaturas	kɾiɐtuɾɐʃ	kriaturaS	o
foge	foʒɛ	foZE	o
fortuna	foɾtunɐ	fortuna	n
observar	obsɛɾvɐɾ	obsErvar	o
física	fizikɐ	fizika	o
estiverem	ɛʃtivɛɾɛ̃	EStivErE*	o
interromper	intɛʁompɛɾ	intEXompEr	o
porto	poɾto	porto	n
falado	fɐlɐdo	falado	o
cadáver	kɐdavɛɾ	kadavEr	o
amanda	ɐmɐndɐ	amanda	o
quantidade	kɐntidɐdɛ	kantidadE	o
paixão	pajksɐ̃w̃	payksa*w*	o
tanque	tɐnkʷɛ	tankw~E	o
escolhido	ɛʃkolido	ESkolido	o
exterior	ɛstɛɾioɾ	EstErior	n
pesado	pɛzɐdo	pEzado	o
chegado	kɛɡɐdo	kEgado	o
resistência	ʁɛziʃtensiɐ	XEziStensia	o
terrorista	tɛʁoɾiʃtɐ	tEXoriSta	o
esconde	ɛʃkondɛ	ESkondE	o
campanha	kɐmpɐnɐ	kampana	o
bauer	bawɛɾ	bawEr	o
emma	ɛmmɐ	Emma	o
fã	fɐ̃	fa*	o
lex	lɛs	lEs	o
estudo	ɛʃtudo	EStudo	o
apetece	ɐpɛtɛzɛ	apEtEzE	o
militares	militɐɾɛʃ	militarES	o
turno	tuɾno	turno	o
abby	ɐbbj	abby	o
mentiu	mɛntiw	mEntiw	o
resgate	ʁɛʃɡɐtɛ	XESgatE	o
fazeres	fɐzɛɾɛʃ	fazErES	o
mostrou	moʃtɾowu	moStrowu	o
produção	pɾodusɐ̃w̃	produsa*w*	o
doida	dowidɐ	dowida	o
anteriormente	ɐntɛɾioɾmɛntɛ	antEriormEntE	o
terras	tɛʁɐʃ	tEXaS	o
ross	ʁosʃ	XosS	n
desgraçado	dɛʃɡɾɐsɐdo	dESgrasado	o
laura	lawɾɐ	lawra	o
agrada	ɐɡʁɐdɐ	agXada	o
traseiras	tɾɐzɛjɾɐʃ	trazEyraS	o
jedi	ʒɛdi	ZEdi	o
doces	dozɛʃ	dozES	o
bebés	bɛbeʃ	bEbeS	o
poucas	powukɐʃ	powukaS	o
primavera	pɾimɐvɛɾɐ	primavEra	o
vampiros	vɐmpiɾoʃ	vampiroS	o
west	wɛʃt	wESt	n
funcionou	funsionowu	funsionowu	o
genial	ʒɛniɐl	ZEnial	s
lata	lɐtɐ	lata	o
arder	ɐɾdɛɾ	ardEr	o
molho	molo	molo	o
doze	dozɛ	dozE	n
esquerdo	ɛʃkʷɛɾdo	ESkw~Erdo	o
exames	ɛzɐmɛʃ	EzamES	o
escolhe	ɛʃkolɛ	ESkolE	o
metido	mɛtido	mEtido	o
pistas	piʃtɐʃ	piStaS	o
ena	ɛnɐ	Ena	o
ouvimos	owuvimoʃ	owuvimoS	o
episódio	ɛpizɔdio	Epizodio	o
olhes	olɛʃ	olES	o
continuam	kontinuɐ̃	kontinua*	o
criminosos	kɾiminozoʃ	kriminozoS	o
prostituta	pɾoʃtitutɐ	proStituta	o
reputação	ʁɛputɐsɐ̃w̃	XEputasa*w*	o
febre	fɛbʁɛ	fEbXE	o
miller	millɛɾ	millEr	n
puro	puɾo	puro	o
so	so	so	n
almas	ɐlmɐʃ	almaS	o
curioso	kuɾiozo	kuriozo	o
terça	tɛɾsɐ	tErsa	o
fred	fɾɛd	frEd	o
combater	kombɐtɛɾ	kombatEr	o
opções	opsʃ	opsS	o
castigo	kɐʃtiɡo	kaStigo	o
separar	sɛpɐɾɐɾ	sEparar	o
civil	sivil	sivil	s
barriga	bɐʁiɡɐ	baXiga	o
park	pɐɾk	park	n
quilómetros	kʷilɔmɛtʁoʃ	kw~ilomEtXoS	o
randy	ʁɐndj	Xandy	s
segure	sɛɡʁɛ	sEgXE	o
sonhar	sonɐɾ	sonar	o
embaixo	ɛmbajkso	Embaykso	o
levantem	lɛvɐntɛ̃	lEvantE*	o
cometer	komɛtɛɾ	komEtEr	o
amostra	ɐmoʃtɾɐ	amoStra	o
despedida	dɛʃpɛdidɐ	dESpEdida	o
ratos	ʁɐtoʃ	XatoS	o
duplo	duplo	duplo	o
bart	bɐɾt	bart	n
lembrem	lɛmbɾɛ̃	lEmbrE*	o
hollywood	olljwowod	ollywowod	n
clínica	klinikɐ	klinika	o
exercício	ɛzɛɾsizio	EzErsizio	o
azar	ɐzɐɾ	azar	o
simpática	simpatikɐ	simpatika	o
cardíaco	kɐɾdiɐko	kardiako	o
metal	mɛtɐl	mEtal	n
levas	lɛvɐʃ	lEvaS	o
mesmas	mɛʃmɐʃ	mESmaS	o
sessão	sɛʃsɐ̃w̃	sESsa*w*	o
golfe	ɡolfɛ	golfE	o
disponível	diʃponivɛl	diSponivEl	o
armazém	ɐɾmɐzẽ	armaze*	o
telefonou	tɛlɛfonowu	tElEfonowu	o
comercial	komɛɾsiɐl	komErsial	o
pura	puɾɐ	pura	o
bicicleta	biziklɛtɐ	biziklEta	o
queimar	kʷɛjmɐɾ	kw~Eymar	o
ataques	ɐtɐkʷɛʃ	atakw~ES	o
atende	ɐtɛndɛ	atEndE	o
nervosa	nɛɾvozɐ	nErvoza	o
trabalhou	tɾɐbɐlowu	trabalowu	o
king	kinɡ	king	n
entregue	ɛntɾɛɡʷɛ	EntrEgw~E	o
queixa	kʷɛjksɐ	kw~Eyksa	o
costume	koʃtumɛ	koStumE	n
mover	movɛɾ	movEr	n
empregada	ɛmpɾɛɡɐdɐ	EmprEgada	o
casados	kɐzɐdoʃ	kazadoS	o
casey	kɐzɛj	kazEy	o
salto	sɐlto	salto	o
vila	vilɐ	vila	n
mudanças	mudɐnsɐʃ	mudansaS	o
cigarros	siɡɐʁoʃ	sigaXoS	o
palácio	pɐlazio	palazio	o
selva	sɛlvɐ	sElva	n
perdida	pɛɾdidɐ	pErdida	o
rezar	ʁɛzɐɾ	XEzar	o
análise	ɐnalizɛ	analizE	o
arranjei	ɐʁɐnʒɛj	aXanZEy	o
poderemos	podɛɾɛmoʃ	podErEmoS	o
mental	mɛntɐl	mEntal	a
cooper	kowopɛɾ	kowopEr	n
lobo	lobo	lobo	o
desejar	dɛzɛʒɐɾ	dEzEZar	o
favorito	fɐvoɾito	favorito	o
julia	ʒuliɐ	Zulia	o
impostos	impoʃtoʃ	impoStoS	o
tolo	tolo	tolo	o
frango	fɾɐnɡo	frango	o
campos	kɐmpoʃ	kampoS	o
trânsito	tɾansito	transito	o
redor	ʁɛdoɾ	XEdor	o
recebemos	ʁɛzɛbɛmoʃ	XEzEbEmoS	o
feitas	fɛjtɐʃ	fEytaS	o
matado	mɐtɐdo	matado	o
circunstâncias	siɾkunstansiɐʃ	sirkunstansiaS	o
andei	ɐndɛj	andEy	o
limpeza	limpɛzɐ	limpEza	o
satisfeito	sɐtiʃfɛjto	satiSfEyto	o
popular	populɐɾ	popular	a
sentiu	sɛntiw	sEntiw	o
molly	mollj	molly	n
comprimidos	kompɾimidoʃ	komprimidoS	o
gordon	ɡoɾdõ	gordo*	o
escutem	ɛʃkutɛ̃	ESkutE*	o
anterior	ɐntɛɾioɾ	antErior	n
dispositivo	diʃpozitivo	diSpozitivo	o
aceite	ɐzɛjtɛ	azEytE	o
atrasada	ɐtʁɐzɐdɐ	atXazada	o
aranha	ɐɾɐnɐ	arana	o
cretino	kɾɛtino	krEtino	o
baby	bɐbj	baby	n
donna	donnɐ	donna	n
penny	pɛnnj	pEnny	n
time	timɛ	timE	n
reacção	ʁɛɐksɐ̃w̃	XEaksa*w*	o
telefona	tɛlɛfonɐ	tElEfona	o
território	tɛʁitɔɾio	tEXitorio	o
aliança	ɐliɐnsɐ	aliansa	o
chinês	kineʃ	kineS	o
convidar	konvidɐɾ	konvidar	o
in	ĩ	i*	n
moeda	mowɛdɐ	mowEda	o
cuecas	kuɛkɐʃ	kuEkaS	o
assumir	ɐʃsumiɾ	aSsumir	o
pagamento	pɐɡɐmɛnto	pagamEnto	o
ombro	ombɾo	ombro	o
face	fɐzɛ	fazE	n
heróis	ɛɾõj̃ʃ	Ero*y*S	o
cenas	sɛnɐʃ	sEnaS	o
nestas	nɛʃtɐʃ	nEStaS	o
promete	pɾomɛtɛ	promEtE	o
compreende	kompɾɛɛndɛ	komprEEndE	o
terminado	tɛɾminɐdo	tErminado	o
besta	bɛʃtɐ	bESta	o
alteza	ɐltɛzɐ	altEza	o
pôde	podɛ	podE	o
mortal	moɾtɐl	mortal	n
sócio	sɔzio	sozio	o
ponho	pono	pono	o
nasci	nɐʃsi	naSsi	o
lou	lowu	lowu	o
conferência	konfɛɾensiɐ	konfErensia	o
círculo	siɾkulo	sirkulo	o
declaração	dɛklɐɾɐsɐ̃w̃	dEklarasa*w*	o
juízo	ʒuj́zo	Zuyzo	o
alemanha	ɐlɛmɐnɐ	alEmana	o
està	ɛʃta	ESta	o
sinta	sintɐ	sinta	o
falhar	fɐlɐɾ	falar	o
dívida	dividɐ	divida	o
trabalhas	tɾɐbɐlɐʃ	trabalaS	o
inspector	inspɛktoɾ	inspEktor	n
atraente	ɐtʁɐɛntɛ	atXaEntE	o
voltará	voltɐɾa	voltara	o
recompensa	ʁɛkompɛnsɐ	XEkompEnsa	o
clara	klɐɾɐ	klara	o
sentimento	sɛntimɛnto	sEntimEnto	o
abençoe	ɐbɛnsowɛ	abEnsowE	o
noutra	nowutʁɐ	nowutXa	o
memórias	mɛmɔɾiɐʃ	mEmoriaS	o
procuramos	pɾokuɾɐmoʃ	prokuramoS	o
arrancar	ɐʁɐnkɐɾ	aXankar	o
venhas	vɛnɐʃ	vEnaS	o
pénis	peniʃ	peniS	o
tinta	tintɐ	tinta	o
né	ne	ne	o
tentado	tɛntɐdo	tEntado	o
montar	montɐɾ	montar	o
ouves	owuvɛʃ	owuvES	o
júri	ʒuɾi	Zuri	o
teríamos	tɛɾiɐmoʃ	tEriamoS	o
condenado	kondɛnɐdo	kondEnado	o
boston	boʃtõ	boSto*	n
motivos	motivoʃ	motivoS	o
quilos	kʷiloʃ	kw~iloS	o
prima	pɾimɐ	prima	n
fresco	fɾɛʃko	frESko	n
deter	dɛtɛɾ	dEtEr	v
boneca	bonɛkɐ	bonEka	o
zangada	zɐnɡɐdɐ	zangada	o
curto	kuɾto	kurto	o
prometeu	pɾomɛtew	promEtew	o
escapou	ɛʃkɐpowu	ESkapowu	o
lançar	lɐnsɐɾ	lansar	o
gostamos	ɡoʃtɐmoʃ	goStamoS	o
ripadas	ʁipɐdɐʃ	XipadaS	o
acertar	ɐzɛɾtɐɾ	azErtar	o
secção	sɛksɐ̃w̃	sEksa*w*	o
inocentes	inozɛntɛʃ	inozEntES	o
peixes	pɛjksɛʃ	pEyksES	o
teddy	tɛddj	tEddy	n
traidor	tɾajdoɾ	traydor	o
iniciar	iniziɐɾ	iniziar	o
factos	fɐktoʃ	faktoS	o
passear	pɐʃsɛɐɾ	paSsEar	o
incomoda	inkomodɐ	inkomoda	o
corajoso	koɾɐʒozo	koraZozo	o
ódio	ɔdio	odio	o
vigiar	viʒiɐɾ	viZiar	o
apanhem	ɐpɐnɛ̃	apanE*	o
ajudo	ɐʒudo	aZudo	o
convite	konvitɛ	konvitE	o
garotos	ɡɐɾotoʃ	garotoS	o
almirante	ɐlmiɾɐntɛ	almirantE	o
direi	diɾɛj	dirEy	o
contaste	kontɐʃtɛ	kontaStE	o
pacote	pɐkotɛ	pakotE	o
assustada	ɐʃsuʃtɐdɐ	aSsuStada	o
perigosa	pɛɾiɡozɐ	pErigoza	o
bonitas	bonitɐʃ	bonitaS	o
gravação	ɡɾɐvɐsɐ̃w̃	gravasa*w*	o
preparada	pɾɛpɐɾɐdɐ	prEparada	o
corram	koʁɐ̃	koXa*	o
nate	nɐtɛ	natE	o
chatear	kɐtɛɐɾ	katEar	o
deita	dɛjtɐ	dEyta	o
cidades	sidɐdɛʃ	sidadES	o
brinde	bɾindɛ	brindE	o
veste	vɛʃtɛ	vEStE	o
trabalhei	tɾɐbɐlɛj	trabalEy	o
espantoso	ɛʃpɐntozo	ESpantozo	o
teriam	tɛɾiɐ̃	tEria*	o
pessoais	pɛʃsowajʃ	pESsowayS	o
helen	ɛlɛ̃	ElE*	n
parto	pɐɾto	parto	o
seriam	sɛɾiɐ̃	sEria*	o
betty	bɛttj	bEtty	o
ondas	ondɐʃ	ondaS	o
audiência	awdiensiɐ	awdiensia	o
connor	konnoɾ	konnor	o
filmar	filmɐɾ	filmar	o
infecção	infɛksɐ̃w̃	infEksa*w*	o
comunicação	komunikɐsɐ̃w̃	komunikasa*w*	o
apontar	ɐpontɐɾ	apontar	o
folga	folɡɐ	folga	o
compromisso	kompɾomiʃso	kompromiSso	o
barba	bɐɾbɐ	barba	o
escritor	ɛʃkɾitoɾ	ESkritor	o
lágrimas	laɡʁimɐʃ	lagXimaS	o
atingir	ɐtinʒiɾ	atinZir	o
caneta	kɐnɛtɐ	kanEta	o
andou	ɐndowu	andowu	o
contactar	kontɐktɐɾ	kontaktar	o
banheiro	bɐnɛjɾo	banEyro	o
cola	kolɐ	kola	n
incidente	insidɛntɛ	insidEntE	o
ron	ʁõ	Xo*	n
capa	kɐpɐ	kapa	o
pasta	pɐʃtɐ	paSta	n
dexter	dɛstɛɾ	dEstEr	s
ethan	ɛtɐ̃	Eta*	o
bancos	bɐnkoʃ	bankoS	o
frankie	fɾɐnkiɛ	frankiE	o
irás	iɾaʃ	iraS	o
ciúmes	siẃmɛʃ	siwmES	o
psiquiatra	psikʷiɐtʁɐ	psikw~iatXa	o
chegada	kɛɡɐdɐ	kEgada	o
doutora	dowutoɾɐ	dowutora	o
cargo	kɐɾɡo	kargo	n
comi	komi	komi	o
mandaram	mɐndɐɾɐ̃	mandara*	o
templo	tɛmplo	tEmplo	o
eva	ɛvɐ	Eva	o
vampiro	vɐmpiɾo	vampiro	o
saindo	sajndo	sayndo	o
aventura	ɐvɛntuɾɐ	avEntura	o
pagam	pɐɡɐ̃	paga*	o
sermos	sɛɾmoʃ	sErmoS	o
recursos	ʁɛkuɾsoʃ	XEkursoS	o
multidão	multidɐ̃w̃	multida*w*	o
chamem	kɐmɛ̃	kamE*	o
romântico	ʁomantiko	Xomantiko	o
autoridades	awtoɾidɐdɛʃ	awtoridadES	o
mail	majl	mayl	n
nestes	nɛʃtɛʃ	nEStES	v
macacos	mɐkɐkoʃ	makakoS	o
puxar	puksɐɾ	puksar	o
fantasia	fɐntɐziɐ	fantazia	n
ocorreu	okoʁew	okoXew	o
dick	dikk	dikk	n
endereço	ɛndɛɾɛso	EndErEso	o
organização	oɾɡɐnizɐsɐ̃w̃	organizasa*w*	o
romance	ʁomɐnsɛ	XomansE	n
nobre	nobʁɛ	nobXE	o
bateria	bɐtɛɾiɐ	batEria	o
adoram	ɐdoɾɐ̃	adora*	o
nathan	nɐtɐ̃	nata*	o
espacial	ɛʃpɐziɐl	ESpazial	o
império	impeɾio	imperio	o
sitio	sitio	sitio	o
perseguir	pɛɾsɛɡʷiɾ	pErsEgw~ir	o
guiar	ɡʷiɐɾ	gw~iar	o
precisares	pɾɛzisɐɾɛʃ	prEzisarES	o
solte	soltɛ	soltE	o
condição	kondisɐ̃w̃	kondisa*w*	o
preocupação	pɾɛokupɐsɐ̃w̃	prEokupasa*w*	o
gary	ɡɐɾj	gary	n
flor	floɾ	flor	o
agarrar	ɐɡɐʁɐɾ	agaXar	o
vomitar	vomitɐɾ	vomitar	o
pares	pɐɾɛʃ	parES	v
recebe	ʁɛzɛbɛ	XEzEbE	o
ira	iɾɐ	ira	n
perdoar	pɛɾdowɐɾ	pErdowar	o
sincronia	sinkɾoniɐ	sinkronia	o
setembro	sɛtɛmbɾo	sEtEmbro	o
acordei	ɐkoɾdɛj	akordEy	o
apagar	ɐpɐɡɐɾ	apagar	o
ta	tɐ	ta	n
espião	ɛʃpiɐ̃w̃	ESpia*w*	o
computadores	komputɐdoɾɛʃ	komputadorES	o
apaixonada	ɐpajksonɐdɐ	apayksonada	o
pouca	powukɐ	powuka	o
lho	lo	lo	o
miles	milɛʃ	milES	n
plástico	plaʃtiko	plaStiko	o
recebido	ʁɛzɛbido	XEzEbido	o
começam	komɛsɐ̃	komEsa*	o
arrumar	ɐʁumɐɾ	aXumar	o
sobretudo	sobʁɛtudo	sobXEtudo	o
depósito	dɛpɔzito	dEpozito	o
especialista	ɛʃpɛziɐliʃtɐ	ESpEzialiSta	o
rips	ʁipʃ	XipS	n
mostro	moʃtɾo	moStro	o
doer	dowɛɾ	dowEr	n
produto	pɾoduto	produto	o
civis	siviʃ	siviS	o
igualmente	iɡɐlmɛntɛ	igalmEntE	o
suspeitos	suʃpɛjtoʃ	suSpEytoS	o
enfim	ɛnfĩ	Enfi*	o
estúdio	ɛʃtudio	EStudio	o
earl	ɛɐɾl	Earl	n
rodas	ʁodɐʃ	XodaS	o
aproveitar	ɐpʁovɛjtɐɾ	apXovEytar	o
moral	moɾɐl	moral	n
certos	sɛɾtoʃ	sErtoS	o
anúncio	ɐnunsio	anunsio	o
escravos	ɛʃkɾɐvoʃ	ESkravoS	o
concurso	konkuɾso	konkurso	o
trabalham	tɾɐbɐlɐ̃	trabala*	o
suficientes	sufiziɛntɛʃ	sufiziEntES	o
péssimo	peʃsimo	peSsimo	o
gatilho	ɡɐtilo	gatilo	o
lincoln	linkol	linkol	n
beth	bɛt	bEt	n
cassete	kɐʃsɛtɛ	kaSsEtE	o
acusação	ɐkuzɐsɐ̃w̃	akuzasa*w*	o
chamei	kɐmɛj	kamEy	o
bandeira	bɐndɛjɾɐ	bandEyra	o
culpar	kulpɐɾ	kulpar	o
ficares	fikɐɾɛʃ	fikarES	o
bíblia	bibliɐ	biblia	o
disparem	diʃpɐɾɛ̃	diSparE*	o
reais	ʁɛajʃ	XEayS	o
secretos	sɛkʁɛtoʃ	sEkXEtoS	o
medicamentos	mɛdikɐmɛntoʃ	mEdikamEntoS	o
voltaste	voltɐʃtɛ	voltaStE	o
salta	sɐltɐ	salta	o
média	mediɐ	media	o
expressão	ɛspɾɛʃsɐ̃w̃	EsprESsa*w*	o
óleo	ɔlɛo	olEo	o
tomo	tomo	tomo	o
turma	tuɾmɐ	turma	o
sumo	sumo	sumo	n
salvá	sɐlva	salva	o
lady	lɐdj	lady	n
hã	ɐ̃	a*	o
usei	uzɛj	uzEy	o
larguem	lɐɾɡʷɛ̃	largw~E*	o
trem	tɾɛ̃	trE*	o
sammy	sɐmmj	sammy	o
controla	kontɾolɐ	kontrola	o
cruz	kɾuʒ	kruZ	o
poderei	podɛɾɛj	podErEy	o
saberia	sɐbɛɾiɐ	sabEria	o
arquivos	ɐɾkʷivoʃ	arkw~ivoS	o
uniforme	unifoɾmɛ	uniformE	o
calar	kɐlɐɾ	kalar	o
cartões	kɐɾtʃ	kartS	o
mortas	moɾtɐʃ	mortaS	o
sally	sɐllj	sally	n
caos	kɐoʃ	kaoS	o
infeliz	infɛliʒ	infEliZ	o
parada	pɐɾɐdɐ	parada	o
reforços	ʁɛfoɾsoʃ	XEforsoS	o
terapia	tɛɾɐpiɐ	tErapia	o
pássaros	paʃsɐɾoʃ	paSsaroS	o
transmissão	tɾɐnsmiʃsɐ̃w̃	transmiSsa*w*	o
refeição	ʁɛfɛjsɐ̃w̃	XEfEysa*w*	o
assassinado	ɐʃsɐʃsinɐdo	aSsaSsinado	o
positivo	pozitivo	pozitivo	o
experiências	ɛspɛɾiensiɐʃ	EspEriensiaS	o
passando	pɐʃsɐndo	paSsando	o
descobre	dɛʃkobʁɛ	dESkobXE	o
passas	pɐʃsɐʃ	paSsaS	o
demos	dɛmoʃ	dEmoS	n
pública	publikɐ	publika	o
nojo	noʒo	noZo	o
chegando	kɛɡɐndo	kEgando	o
concerto	konsɛɾto	konsErto	n
oficialmente	ofiziɐlmɛntɛ	ofizialmEntE	o
anjos	ɐnʒoʃ	anZoS	o
título	titulo	titulo	o
chegam	kɛɡɐ̃	kEga*	o
anormal	ɐnoɾmɐl	anormal	o
deixando	dɛjksɐndo	dEyksando	o
houvesse	owuvɛʃsɛ	owuvESsE	o
frodo	fɾodo	frodo	o
águas	aɡɐʃ	agaS	o
voto	voto	voto	o
vizinho	vizino	vizino	o
presta	pɾɛʃtɐ	prESta	o
privada	pɾivɐdɐ	privada	o
pausa	pawzɐ	pawza	o
reféns	ʁɛfenʃ	XEfenS	o
prazo	pɾɐzo	prazo	o
man	mɐ̃	ma*	n
figura	fiɡʁɐ	figXa	o
berlim	bɛɾlĩ	bErli*	o
michelle	mikɛllɛ	mikEllE	o
coroa	koɾowɐ	korowa	o
bestial	bɛʃtiɐl	bEStial	s
gatos	ɡɐtoʃ	gatoS	o
internacional	intɛɾnɐzionɐl	intErnazional	o
compreendes	kompɾɛɛndɛʃ	komprEEndES	o
apostas	ɐpoʃtɐʃ	apoStaS	o
lança	lɐnsɐ	lansa	o
adiante	ɐdiɐntɛ	adiantE	o
leão	lɛɐ̃w̃	lEa*w*	o
estarmos	ɛʃtɐɾmoʃ	EStarmoS	o
verá	vɛɾa	vEra	o
atrasados	ɐtʁɐzɐdoʃ	atXazadoS	o
baixar	bajksɐɾ	bayksar	o
tentaram	tɛntɐɾɐ̃	tEntara*	o
reunir	ʁewniɾ	Xewnir	o
corra	koʁɐ	koXa	o
pila	pilɐ	pila	o
possivelmente	poʃsivɛlmɛntɛ	poSsivElmEntE	o
planear	plɐnɛɐɾ	planEar	o
esperam	ɛʃpɛɾɐ̃	ESpEra*	o
fígado	fiɡɐdo	figado	o
fatos	fɐtoʃ	fatoS	o
pedimos	pɛdimoʃ	pEdimoS	o
intervalo	intɛɾvɐlo	intErvalo	o
gastar	ɡɐʃtɐɾ	gaStar	o
seguida	sɛɡʷidɐ	sEgw~ida	o
temporada	tɛmpoɾɐdɐ	tEmporada	o
brad	bɾɐd	brad	n
mudaram	mudɐɾɐ̃	mudara*	o
altamente	ɐltɐmɛntɛ	altamEntE	o
sincronizadas	sinkɾonizɐdɐʃ	sinkronizadaS	o
homicídios	omizidioʃ	omizidioS	o
goste	ɡoʃtɛ	goStE	o
costuma	koʃtumɐ	koStuma	o
ian	iɐ̃	ia*	o
heroína	ɛɾowinɐ	Erowina	o
esqueceste	ɛʃkʷɛzɛʃtɛ	ESkw~EzEStE	o
césar	sezɐɾ	sezar	o
carol	kɐɾol	karol	n
safar	sɐfɐɾ	safar	n
origem	oɾiʒɛ̃	oriZE*	o
tivéssemos	tiveʃsɛmoʃ	tiveSsEmoS	o
destruído	dɛʃtɾuj́do	dEStruydo	o
união	uniɐ̃w̃	unia*w*	o
descobrimos	dɛʃkobʁimoʃ	dESkobXimoS	o
enviado	ɛnviɐdo	Enviado	o
perdoa	pɛɾdowɐ	pErdowa	o
acusado	ɐkuzɐdo	akuzado	o
white	witɛ	witE	n
julguei	ʒulɡʷɛj	Zulgw~Ey	o
meias	mɛjɐʃ	mEyaS	o
luvas	luvɐʃ	luvaS	o
ladrões	lɐdʁʃ	ladXS	o
diverte	divɛɾtɛ	divErtE	o
apanharam	ɐpɐnɐɾɐ̃	apanara*	o
feia	fɛjɐ	fEya	o
prata	pɾɐtɐ	prata	o
sagrado	sɐɡʁɐdo	sagXado	o
direção	diɾɛsɐ̃w̃	dirEsa*w*	o
fizeres	fizɛɾɛʃ	fizErES	o
dizemos	dizɛmoʃ	dizEmoS	o
ansioso	ɐnsiozo	ansiozo	o
vistos	viʃtoʃ	viStoS	o
confie	konfiɛ	konfiE	o
vende	vɛndɛ	vEndE	o
ashley	ɐʃlɛj	aSlEy	o
passageiros	pɐʃsɐʒɛjɾoʃ	paSsaZEyroS	o
acusações	ɐkuzɐsʃ	akuzasS	o
passava	pɐʃsɐvɐ	paSsava	o
leia	lɛjɐ	lEya	o
geralmente	ʒɛɾɐlmɛntɛ	ZEralmEntE	o
matemática	mɐtɛmatikɐ	matEmatika	o
julgar	ʒulɡɐɾ	Zulgar	o
libras	libʁɐʃ	libXaS	n
sensível	sɛnsivɛl	sEnsivEl	o
sincero	sinsɛɾo	sinsEro	o
estupidez	ɛʃtupidɛʒ	EStupidEZ	o
traição	tɾajsɐ̃w̃	traysa*w*	o
participar	pɐɾtizipɐɾ	partizipar	o
sorrir	soʁiɾ	soXir	o
iá	ia	ia	o
frase	fɾɐzɛ	frazE	o
camarada	kɐmɐɾɐdɐ	kamarada	o
evento	ɛvɛnto	EvEnto	o
salão	sɐlɐ̃w̃	sala*w*	o
despachar	dɛʃpɐkɐɾ	dESpakar	o
jóias	ʒɔjɐʃ	ZoyaS	o
células	selulɐʃ	selulaS	o
manteiga	mɐntɛjɡɐ	mantEyga	o
piano	piɐno	piano	n
símbolo	simbolo	simbolo	o
lealdade	lɛɐldɐdɛ	lEaldadE	o
cidadãos	sidɐdɐ̃w̃ʃ	sidada*w*S	o
coelho	kowɛlo	kowElo	o
barcos	bɐɾkoʃ	barkoS	o
contagem	kontɐʒɛ̃	kontaZE*	o
pudéssemos	pudeʃsɛmoʃ	pudeSsEmoS	o
vincent	vinsɛnt	vinsEnt	o
falhado	fɐlɐdo	falado	o
gostavas	ɡoʃtɐvɐʃ	goStavaS	o
sabíamos	sɐbiɐmoʃ	sabiamoS	o
vivia	viviɐ	vivia	o
iraque	iɾɐkʷɛ	irakw~E	o
adultos	ɐdultoʃ	adultoS	o
consequências	konsɛkʷensiɐʃ	konsEkw~ensiaS	o
avisei	ɐvizɛj	avizEy	o
atacou	ɐtɐkowu	atakowu	o
perderam	pɛɾdɛɾɐ̃	pErdEra*	o
encontrarmos	ɛnkontɾɐɾmoʃ	EnkontrarmoS	o
nancy	nɐnsj	nansy	n
encher	ɛnkɛɾ	EnkEr	o
leu	lew	lew	n
pensem	pɛnsɛ̃	pEnsE*	o
informar	infoɾmɐɾ	informar	o
identificar	idɛntifikɐɾ	idEntifikar	o
lewis	lɛwiʃ	lEwiS	n
estranhas	ɛʃtɾɐnɐʃ	EStranaS	o
estudante	ɛʃtudɐntɛ	EStudantE	o
dylan	djlɐ̃	dyla*	n
estivesses	ɛʃtivɛʃsɛʃ	EStivESsES	o
abertos	ɐbɛɾtoʃ	abErtoS	o
esperta	ɛʃpɛɾtɐ	ESpErta	o
actor	ɐktoɾ	aktor	n
precisamente	pɾɛzisɐmɛntɛ	prEzisamEntE	o
angela	ɐnʒɛlɐ	anZEla	o
jacob	ʒɐkob	Zakob	n
pecado	pɛkɐdo	pEkado	o
atire	ɐtiɾɛ	atirE	o
engraçada	ɛnɡɾɐsɐdɐ	Engrasada	o
existência	ɛziʃtensiɐ	EziStensia	o
casou	kɐzowu	kazowu	o
barato	bɐɾɐto	barato	o
desce	dɛʃsɛ	dESsE	o
copos	kopoʃ	kopoS	o
robô	ʁobo	Xobo	o
cientistas	siɛntiʃtɐʃ	siEntiStaS	o
dali	dɐli	dali	n
gravidade	ɡɾɐvidɐdɛ	gravidadE	o
anne	ɐnnɛ	annE	n
urgente	uɾʒɛntɛ	urZEntE	o
sydney	sjdnɛj	sydnEy	n
caminhar	kɐminɐɾ	kaminar	o
sabor	sɐboɾ	sabor	o
ovo	ovo	ovo	o
linguagem	linɡɐʒɛ̃	lingaZE*	o
adorei	ɐdoɾɛj	adorEy	o
fazerem	fɐzɛɾɛ̃	fazErE*	o
questões	kʷɛʃtʃ	kw~EStS	o
imaginação	imɐʒinɐsɐ̃w̃	imaZinasa*w*	o
importar	impoɾtɐɾ	importar	o
termina	tɛɾminɐ	tErmina	o
escudo	ɛʃkudo	ESkudo	n
barney	bɐɾnɛj	barnEy	o
estudantes	ɛʃtudɐntɛʃ	EStudantES	o
deveriam	dɛvɛɾiɐ̃	dEvEria*	o
decente	dɛzɛntɛ	dEzEntE	o
remédio	ʁɛmedio	XEmedio	o
hmm	m	m	o
jogadores	ʒoɡɐdoɾɛʃ	ZogadorES	o
saíram	saj́ɾɐ̃	sayra*	o
equipas	ɛkʷipɐʃ	Ekw~ipaS	o
chamá	kɐma	kama	o
mm	m	m	n
religião	ʁɛliʒiɐ̃w̃	XEliZia*w*	o
acontecerá	ɐkontɛzɛɾa	akontEzEra	o
profundo	pɾofundo	profundo	o
dormi	doɾmi	dormi	o
saberá	sɐbɛɾa	sabEra	o
aquí	ɐkʷi	akw~i	o
interessada	intɛɾɛʃsɐdɐ	intErESsada	o
japão	ʒɐpɐ̃w̃	Zapa*w*	o
abraço	ɐbʁɐso	abXaso	o
patrulha	pɐtʁulɐ	patXula	o
perímetro	pɛɾimɛtʁo	pErimEtXo	o
infância	infansiɐ	infansia	o
mentes	mɛntɛʃ	mEntES	o
perdidos	pɛɾdidoʃ	pErdidoS	o
dada	dɐdɐ	dada	n
abri	ɐbʁi	abXi	o
sacrifício	sɐkʁifizio	sakXifizio	o
falsa	fɐlsɐ	falsa	o
competição	kompɛtisɐ̃w̃	kompEtisa*w*	o
excelência	ɛsɛlensiɐ	EsElensia	o
feche	fɛkɛ	fEkE	o
entraram	ɛntɾɐɾɐ̃	Entrara*	o
trouxeram	tɾowuksɛɾɐ̃	trowuksEra*	o
tivermos	tivɛɾmoʃ	tivErmoS	o
cientista	siɛntiʃtɐ	siEntiSta	o
menti	mɛnti	mEnti	o
cobrir	kobʁiɾ	kobXir	o
pediste	pɛdiʃtɛ	pEdiStE	o
índia	indiɐ	india	o
considerar	konsidɛɾɐɾ	konsidErar	o
relaxar	ʁɛlɐksɐɾ	XElaksar	o
excitante	ɛsitɐntɛ	EsitantE	o
convidou	konvidowu	konvidowu	o
ideal	idɛɐl	idEal	n
estarem	ɛʃtɐɾɛ̃	EStarE*	o
descanso	dɛʃkɐnso	dESkanso	o
viagens	viɐʒɛnʃ	viaZEnS	o
deixamos	dɛjksɐmoʃ	dEyksamoS	o
espanhol	ɛʃpɐnol	ESpanol	o
farta	fɐɾtɐ	farta	o
lance	lɐnsɛ	lansE	n
valha	vɐlɐ	vala	o
mínima	minimɐ	minima	o
mijar	miʒɐɾ	miZar	o
ofereceu	ofɛɾɛzew	ofErEzew	o
morar	moɾɐɾ	morar	o
nu	nu	nu	n
olhou	olowu	olowu	o
estrutura	ɛʃtɾutuɾɐ	EStrutura	o
renda	ʁɛndɐ	XEnda	o
charlotte	kɐɾlottɛ	karlottE	n
oliver	olivɛɾ	olivEr	n
imensa	imɛnsɐ	imEnsa	o
cheirar	kɛjɾɐɾ	kEyrar	o
steven	stɛvɛ̃	stEvE*	o
resolvido	ʁɛzolvido	XEzolvido	o
emoções	ɛmosʃ	EmosS	o
acontecem	ɐkontɛzɛ̃	akontEzE*	o
impacto	impɐkto	impakto	o
passaste	pɐʃsɐʃtɛ	paSsaStE	o
nascimento	nɐʃsimɛnto	naSsimEnto	o
curar	kuɾɐɾ	kurar	o
passámos	pɐʃsamoʃ	paSsamoS	o
italiano	itɐliɐno	italiano	o
sophie	sopiɛ	sopiE	o
esqueçam	ɛʃkʷɛsɐ̃	ESkw~Esa*	o
mães	mɐ̃j̃ʃ	ma*y*S	o
principalmente	pɾinsipɐlmɛntɛ	prinsipalmEntE	o
recolher	ʁɛkolɛɾ	XEkolEr	o
transferência	tɾɐnsfɛɾensiɐ	transfErensia	o
respiração	ʁɛʃpiɾɐsɐ̃w̃	XESpirasa*w*	o
disparate	diʃpɐɾɐtɛ	diSparatE	s
escada	ɛʃkɐdɐ	ESkada	o
cento	sɛnto	sEnto	o
potencial	potɛnsiɐl	potEnsial	o
testar	tɛʃtɐɾ	tEStar	o
caçador	kɐsɐdoɾ	kasador	o
protege	pɾotɛʒɛ	protEZE	n
filhas	filɐʃ	filaS	o
gorda	ɡoɾdɐ	gorda	o
sentada	sɛntɐdɐ	sEntada	o
saibam	sajbɐ̃	sayba*	o
ricky	ʁikkj	Xikky	o
meta	mɛtɐ	mEta	o
motel	motɛl	motEl	n
acorde	ɐkoɾdɛ	akordE	o
técnica	teknikɐ	teknika	o
recepção	ʁɛzɛpsɐ̃w̃	XEzEpsa*w*	o
primeiras	pɾimɛjɾɐʃ	primEyraS	o
sacos	sɐkoʃ	sakoS	o
jornalista	ʒoɾnɐliʃtɐ	ZornaliSta	o
efeitos	ɛfɛjtoʃ	EfEytoS	o
logan	loɡɐ̃	loga*	n
matéria	mɐteɾiɐ	materia	o
disparou	diʃpɐɾowu	diSparowu	o
séculos	sekuloʃ	sekuloS	o
laranja	lɐɾɐnʒɐ	laranZa	o
imaginei	imɐʒinɛj	imaZinEy	o
portal	poɾtɐl	portal	n
rússia	ʁuʃsiɐ	XuSsia	o
continuamos	kontinuɐmoʃ	kontinuamoS	o
construção	konstɾusɐ̃w̃	konstrusa*w*	o
coluna	kolunɐ	koluna	o
black	blɐkk	blakk	n
brinquedos	bɾinkʷɛdoʃ	brinkw~EdoS	o
resultou	ʁɛzultowu	XEzultowu	o
posse	poʃsɛ	poSsE	n
tragédia	tɾɐʒediɐ	traZedia	o
tensão	tɛnsɐ̃w̃	tEnsa*w*	o
jennifer	ʒɛnnifɛɾ	ZEnnifEr	o
olivia	oliviɐ	olivia	o
neil	nɛjl	nEyl	o
pulmões	pulmʃ	pulmS	o
faziam	fɐziɐ̃	fazia*	o
roda	ʁodɐ	Xoda	o
localizar	lokɐlizɐɾ	lokalizar	o
circo	siɾko	sirko	o
formos	foɾmoʃ	formoS	o
duche	dukɛ	dukE	o
deverias	dɛvɛɾiɐʃ	dEvEriaS	o
tocou	tokowu	tokowu	o
coca	kokɐ	koka	n
nina	ninɐ	nina	n
horário	oɾaɾio	orario	o
conjunto	konʒunto	konZunto	o
riscos	ʁiʃkoʃ	XiSkoS	o
souber	sowubɛɾ	sowubEr	o
empregados	ɛmpɾɛɡɐdoʃ	EmprEgadoS	o
voltaram	voltɐɾɐ̃	voltara*	o
violação	violɐsɐ̃w̃	violasa*w*	o
munições	munisʃ	munisS	o
combinação	kombinɐsɐ̃w̃	kombinasa*w*	o
condutor	kondutoɾ	kondutor	o
relatórios	ʁɛlɐtɔɾioʃ	XElatorioS	o
porcos	poɾkoʃ	porkoS	o
jonathan	ʒonɐtɐ̃	Zonata*	n
rica	ʁikɐ	Xika	o
mágica	maʒikɐ	maZika	o
resistir	ʁɛziʃtiɾ	XEziStir	o
celular	sɛlulɐɾ	sElular	o
monstros	monstɾoʃ	monstroS	o
jordan	ʒoɾdɐ̃	Zorda*	n
esperei	ɛʃpɛɾɛj	ESpErEy	o
durar	duɾɐɾ	durar	o
lama	lɐmɐ	lama	n
voltes	voltɛʃ	voltES	o
existir	ɛziʃtiɾ	EziStir	o
on	õ	o*	a
percebido	pɛɾsɛbido	pErsEbido	o
dizeres	dizɛɾɛʃ	dizErES	o
apanho	ɐpɐno	apano	o
terror	tɛʁoɾ	tEXor	n
uísque	uj́ʃkʷɛ	uySkw~E	o
explosivos	ɛsplozivoʃ	EsplozivoS	o
substituir	substitujɾ	substituyr	o
benjamin	bɛnʒɐmĩ	bEnZami*	n
usava	uzɐvɐ	uzava	o
trazido	tɾɐzido	trazido	o
certificar	sɛɾtifikɐɾ	sErtifikar	o
cobre	kobʁɛ	kobXE	o
tecnicamente	tɛknikɐmɛntɛ	tEknikamEntE	o
podermos	podɛɾmoʃ	podErmoS	o
baixem	bajksɛ̃	bayksE*	o
peguem	pɛɡʷɛ̃	pEgw~E*	o
terias	tɛɾiɐʃ	tEriaS	o
arquivo	ɐɾkʷivo	arkw~ivo	o
câmera	kamɛɾɐ	kamEra	o
mulder	muldɛɾ	muldEr	o
visual	vizuɐl	vizual	a
plantas	plɐntɐʃ	plantaS	o
acreditava	ɐkʁɛditɐvɐ	akXEditava	o
termo	tɛɾmo	tErmo	o
academia	ɐkɐdɛmiɐ	akadEmia	n
região	ʁɛʒiɐ̃w̃	XEZia*w*	o
miranda	miɾɐndɐ	miranda	o
roubaram	ʁowubɐɾɐ̃	Xowubara*	o
cuide	kujdɛ	kuydE	o
corações	koɾɐsʃ	korasS	o
serena	sɛɾɛnɐ	sErEna	o
tentamos	tɛntɐmoʃ	tEntamoS	o
devesse	dɛvɛʃsɛ	dEvESsE	o
nua	nuɐ	nua	o
andamos	ɐndɐmoʃ	andamoS	o
patético	pɐtetiko	patetiko	o
folha	folɐ	fola	o
paragem	pɐɾɐʒɛ̃	paraZE*	o
dês	deʃ	deS	o
contudo	kontudo	kontudo	o
decide	dɛzidɛ	dEzidE	v
república	ʁɛpublikɐ	XEpublika	o
caridade	kɐɾidɐdɛ	karidadE	o
encontrem	ɛnkontɾɛ̃	EnkontrE*	o
dará	dɐɾa	dara	o
vazia	vɐziɐ	vazia	o
argumento	ɐɾɡmɛnto	argmEnto	o
secretário	sɛkʁɛtaɾio	sEkXEtario	o
orgulhosa	oɾɡlozɐ	orgloza	o
embaixador	ɛmbajksɐdoɾ	Embayksador	o
aaron	ɐɐɾõ	aaro*	n
kg	kɡ	kg	n
lixado	liksɐdo	liksado	o
desconhecido	dɛʃkonɛzido	dESkonEzido	o
acabe	ɐkɐbɛ	akabE	o
espíritos	ɛʃpiɾitoʃ	ESpiritoS	o
poderosa	podɛɾozɐ	podEroza	o
sheldon	sɛldõ	sEldo*	o
chase	kɐzɛ	kazE	n
pego	pɛɡo	pEgo	o
sobrinho	sobʁino	sobXino	o
votos	votoʃ	votoS	o
perfil	pɛɾfil	pErfil	o
celebrar	sɛlɛbʁɐɾ	sElEbXar	o
petróleo	pɛtʁɔlɛo	pEtXolEo	o
custódia	kuʃtɔdiɐ	kuStodia	o
walker	wɐlkɛɾ	walkEr	n
delicioso	dɛliziozo	dEliziozo	o
rocky	ʁokkj	Xokky	s
rebentar	ʁɛbɛntɐɾ	XEbEntar	o
assegurar	ɐʃsɛɡʁɐɾ	aSsEgXar	o
tema	tɛmɐ	tEma	o
lorque	loɾkʷɛ	lorkw~E	o
jersey	ʒɛɾsɛj	ZErsEy	n
apanhaste	ɐpɐnɐʃtɛ	apanaStE	o
propriamente	pɾopʁiɐmɛntɛ	propXiamEntE	o
jay	ʒɐj	Zay	n
tradição	tɾɐdisɐ̃w̃	tradisa*w*	o
julho	ʒulo	Zulo	o
sentindo	sɛntindo	sEntindo	o
unhas	unɐʃ	unaS	o
doidos	dowidoʃ	dowidoS	o
mickey	mikkɛj	mikkEy	n
blair	blajɾ	blayr	n
níveis	nivɛjʃ	nivEyS	o
aparelho	ɐpɐɾɛlo	aparElo	o
ensaio	ɛnsɐjo	Ensayo	o
chateada	kɐtɛɐdɐ	katEada	o
elliot	ɛlliot	Elliot	o
cerebral	sɛɾɛbʁɐl	sErEbXal	a
kent	kɛnt	kEnt	n
aumento	awmɛnto	awmEnto	o
ferramentas	fɛʁɐmɛntɐʃ	fEXamEntaS	o
disfarce	diʃfɐɾsɛ	diSfarsE	o
dólar	dɔlɐɾ	dolar	o
dose	dozɛ	dozE	n
rumo	ʁumo	Xumo	o
wall	wɐll	wall	n
caroline	kɐɾolinɛ	karolinE	a
frequência	fɾɛkʷensiɐ	frEkw~ensia	o
sid	sid	sid	o
morra	moʁɐ	moXa	o
baseado	bɐzɛɐdo	bazEado	o
amostras	ɐmoʃtɾɐʃ	amoStraS	o
agenda	ɐʒɛndɐ	aZEnda	n
ellie	ɛlliɛ	ElliE	o
estudos	ɛʃtudoʃ	EStudoS	o
martha	mɐɾtɐ	marta	o
franceses	fɾɐnsɛzɛʃ	fransEzES	n
tracy	tɾɐzj	trazy	n
deixarei	dɛjksɐɾɛj	dEyksarEy	o
moça	mosɐ	mosa	o
páginas	paʒinɐʃ	paZinaS	o
cemitério	sɛmiteɾio	sEmiterio	o
dente	dɛntɛ	dEntE	o
ari	ɐɾi	ari	o
roubei	ʁowubɛj	XowubEy	o
conseguirmos	konsɛɡʷiɾmoʃ	konsEgw~irmoS	o
detrás	dɛtʁaʃ	dEtXaS	o
campeonato	kɐmpɛonɐto	kampEonato	o
egoísta	ɛɡowiʃtɐ	EgowiSta	o
personagem	pɛɾsonɐʒɛ̃	pErsonaZE*	o
beco	bɛko	bEko	o
cabana	kɐbɐnɐ	kabana	n
pintar	pintɐɾ	pintar	o
novidades	novidɐdɛʃ	novidadES	o
cobarde	kobɐɾdɛ	kobardE	o
sobreviventes	sobʁɛvivɛntɛʃ	sobXEvivEntES	o
cores	koɾɛʃ	korES	n
vigia	viʒiɐ	viZia	o
salada	sɐlɐdɐ	salada	o
escolhi	ɛʃkoli	ESkoli	o
furioso	fuɾiozo	furiozo	o
dividir	dividiɾ	dividir	o
shaw	sɐw	saw	n
máxima	maksimɐ	maksima	o
truques	tɾukʷɛʃ	trukw~ES	o
professores	pɾofɛʃsoɾɛʃ	profESsorES	o
dizê	dize	dize	o
manual	mɐnuɐl	manual	n
coordenadas	kowoɾdɛnɐdɐʃ	kowordEnadaS	o
administração	ɐdminiʃtɾɐsɐ̃w̃	adminiStrasa*w*	o
sentimos	sɛntimoʃ	sEntimoS	o
puseram	puzɛɾɐ̃	puzEra*	o
quinze	kʷinzɛ	kw~inzE	o
colocá	koloka	koloka	o
mudam	mudɐ̃	muda*	o
países	paj́zɛʃ	payzES	o
sairmos	sajɾmoʃ	sayrmoS	o
sofreu	sofʁew	sofXew	o
hannah	ɐnnɐ	anna	o
grupos	ɡɾupoʃ	grupoS	o
amarelo	ɐmɐɾɛlo	amarElo	o
apoiar	ɐpowjɐɾ	apowyar	o
poderias	podɛɾiɐʃ	podEriaS	o
bloco	bloko	bloko	o
procedimento	pɾozɛdimɛnto	prozEdimEnto	o
ficha	fikɐ	fika	o
acabam	ɐkɐbɐ̃	akaba*	o
francamente	fɾɐnkɐmɛntɛ	frankamEntE	o
atrasar	ɐtʁɐzɐɾ	atXazar	o
aço	ɐso	aso	o
vingar	vinɡɐɾ	vingar	o
protegê	pɾotɛʒe	protEZe	o
apresentação	ɐpʁɛzɛntɐsɐ̃w̃	apXEzEntasa*w*	o
contratar	kontɾɐtɐɾ	kontratar	o
carrie	kɐʁiɛ	kaXiE	o
custar	kuʃtɐɾ	kuStar	o
relacionamento	ʁɛlɐzionɐmɛnto	XElazionamEnto	o
reconhecimento	ʁɛkonɛzimɛnto	XEkonEzimEnto	o
façamos	fɐsɐmoʃ	fasamoS	o
verdadeiros	vɛɾdɐdɛjɾoʃ	vErdadEyroS	o
trabalhamos	tɾɐbɐlɐmoʃ	trabalamoS	o
poço	poso	poso	o
códigos	kɔdiɡoʃ	kodigoS	o
ned	nɛd	nEd	o
dirige	diɾiʒɛ	diriZE	o
amável	ɐmavɛl	amavEl	o
gravar	ɡɾɐvɐɾ	gravar	o
letra	lɛtʁɐ	lEtXa	o
sintomas	sintomɐʃ	sintomaS	o
envolver	ɛnvolvɛɾ	EnvolvEr	o
assusta	ɐʃsuʃtɐ	aSsuSta	o
felizmente	fɛliʒmɛntɛ	fEliZmEntE	o
valeu	vɐlew	valew	o
praticar	pɾɐtikɐɾ	pratikar	o
azuis	ɐzujʃ	azuyS	o
escutar	ɛʃkutɐɾ	ESkutar	o
hill	ill	ill	n
vives	vivɛʃ	vivES	o
junta	ʒuntɐ	Zunta	n
aparência	ɐpɐɾensiɐ	aparensia	o
reconhecer	ʁɛkonɛzɛɾ	XEkonEzEr	o
davis	dɐviʃ	daviS	n
preferido	pɾɛfɛɾido	prEfErido	o
fascinante	fɐʃsinɐntɛ	faSsinantE	o
pam	pɐ̃	pa*	o
justin	ʒuʃtĩ	ZuSti*	o
camisola	kɐmizolɐ	kamizola	o
custou	kuʃtowu	kuStowu	o
chover	kovɛɾ	kovEr	o
recente	ʁɛzɛntɛ	XEzEntE	o
nascido	nɐʃsido	naSsido	o
soltar	soltɐɾ	soltar	o
sois	sowiʃ	sowiS	o
ficheiros	fikɛjɾoʃ	fikEyroS	o
beira	bɛjɾɐ	bEyra	n
salário	sɐlaɾio	salario	o
personalidade	pɛɾsonɐlidɐdɛ	pErsonalidadE	o
respondeu	ʁɛʃpondew	XESpondew	o
aprendeu	ɐpʁɛndew	apXEndew	o
pecados	pɛkɐdoʃ	pEkadoS	o
representa	ʁɛpʁɛzɛntɐ	XEpXEzEnta	o
curta	kuɾtɐ	kurta	o
vôo	voo	voo	o
solteiro	soltɛjɾo	soltEyro	o
olhei	olɛj	olEy	o
geração	ʒɛɾɐsɐ̃w̃	ZErasa*w*	o
ignorar	iɡnoɾɐɾ	ignorar	o
solar	solɐɾ	solar	a
seth	sɛt	sEt	n
direto	diɾɛto	dirEto	o
elaine	ɛlajnɛ	ElaynE	o
paguei	pɐɡʷɛj	pagw~Ey	o
ótima	ɔtimɐ	otima	o
telefones	tɛlɛfonɛʃ	tElEfonES	o
escrita	ɛʃkɾitɐ	ESkrita	o
cortou	koɾtowu	kortowu	o
rotina	ʁotinɐ	Xotina	o
motores	motoɾɛʃ	motorES	v
feridos	fɛɾidoʃ	fEridoS	o
formação	foɾmɐsɐ̃w̃	formasa*w*	o
tecido	tɛzido	tEzido	o
sejamos	sɛʒɐmoʃ	sEZamoS	o
detetive	dɛtɛtivɛ	dEtEtivE	o
naturalmente	nɐtuɾɐlmɛntɛ	naturalmEntE	o
lindas	lindɐʃ	lindaS	o
tiraram	tiɾɐɾɐ̃	tirara*	o
sítios	sitioʃ	sitioS	o
assinatura	ɐʃsinɐtuɾɐ	aSsinatura	o
enganou	ɛnɡɐnowu	Enganowu	o
comem	komɛ̃	komE*	o
colar	kolɐɾ	kolar	o
actividade	ɐktividɐdɛ	aktividadE	o
reparar	ʁɛpɐɾɐɾ	XEparar	o
prepare	pɾɛpɐɾɛ	prEparE	v
irem	iɾɛ̃	irE*	o
alcançar	ɐlkɐnsɐɾ	alkansar	o
manhattan	mɐnɐttɐ̃	manatta*	n
exposição	ɛspozisɐ̃w̃	Espozisa*w*	o
buracos	buɾɐkoʃ	burakoS	o
oiça	owisɐ	owisa	o
lembrei	lɛmbɾɛj	lEmbrEy	o
pressentimento	pɾɛʃsɛntimɛnto	prESsEntimEnto	o
desporto	dɛʃpoɾto	dESporto	o
senado	sɛnɐdo	sEnado	o
ação	ɐsɐ̃w̃	asa*w*	o
desapareceram	dɛzɐpɐɾɛzɛɾɐ̃	dEzaparEzEra*	o
banheira	bɐnɛjɾɐ	banEyra	o
reparei	ʁɛpɐɾɛj	XEparEy	o
desenho	dɛzɛno	dEzEno	o
permita	pɛɾmitɐ	pErmita	o
miguel	miɡʷɛl	migw~El	o
grant	ɡɾɐnt	grant	n
kong	konɡ	kong	o
telefono	tɛlɛfono	tElEfono	o
farias	fɐɾiɐʃ	fariaS	o
gravata	ɡɾɐvɐtɐ	gravata	o
estúpidos	ɛʃtupidoʃ	EStupidoS	o
dennis	dɛnniʃ	dEnniS	o
cumprimentos	kumpɾimɛntoʃ	kumprimEntoS	o
causou	kawzowu	kawzowu	o
comunicar	komunikɐɾ	komunikar	o
minas	minɐʃ	minaS	n
favorita	fɐvoɾitɐ	favorita	o
relaxe	ʁɛlɐksɛ	XElaksE	o
confessar	konfɛʃsɐɾ	konfESsar	o
traficante	tɾɐfikɐntɛ	trafikantE	o
encontram	ɛnkontɾɐ̃	Enkontra*	o
repara	ʁɛpɐɾɐ	XEpara	o
planta	plɐntɐ	planta	o
importam	impoɾtɐ̃	importa*	o
ligações	liɡɐsʃ	ligasS	o
funcionam	funsionɐ̃	funsiona*	o
sapato	sɐpɐto	sapato	o
sugerir	suʒɛɾiɾ	suZErir	o
próximas	pɾɔksimɐʃ	proksimaS	o
valer	vɐlɛɾ	valEr	o
vozes	vozɛʃ	vozES	o
saem	sɐɛ̃	saE*	o
toby	tobj	toby	n
chip	kip	kip	n
cerimónia	sɛɾimɔniɐ	sErimonia	o
tubo	tubo	tubo	o
ficarmos	fikɐɾmoʃ	fikarmoS	o
sexuais	sɛksuajʃ	sEksuayS	o
aborrecido	ɐboʁɛzido	aboXEzido	o
conseguido	konsɛɡʷido	konsEgw~ido	o
formar	foɾmɐɾ	formar	o
farão	fɐɾɐ̃w̃	fara*w*	o
jill	ʒill	Zill	o
falhou	fɐlowu	falowu	o
literalmente	litɛɾɐlmɛntɛ	litEralmEntE	o
morrendo	moʁɛndo	moXEndo	o
moedas	mowɛdɐʃ	mowEdaS	o
cabrões	kɐbʁʃ	kabXS	o
lucas	lukɐʃ	lukaS	n
ão	ɐ̃w̃	a*w*	o
curiosidade	kuɾiozidɐdɛ	kuriozidadE	o
burke	buɾkɛ	burkE	n
casino	kɐzino	kazino	n
sobrevivência	sobʁɛvivensiɐ	sobXEvivensia	o
ramo	ʁɐmo	Xamo	o
troco	tɾoko	troko	o
canta	kɐntɐ	kanta	o
condicional	kondizionɐl	kondizional	o
rita	ʁitɐ	Xita	o
prefere	pɾɛfɛɾɛ	prEfErE	o
devolve	dɛvolvɛ	dEvolvE	v
dobro	dobʁo	dobXo	o
tirando	tiɾɐndo	tirando	o
tiroteio	tiɾotɛjo	tirotEyo	o
desejos	dɛzɛʒoʃ	dEzEZoS	o
poderão	podɛɾɐ̃w̃	podEra*w*	o
invasão	invɐzɐ̃w̃	invaza*w*	o
darei	dɐɾɛj	darEy	o
creme	kɾɛmɛ	krEmE	o
policiais	poliziajʃ	poliziayS	o
oxalá	oksɐla	oksala	o
esperas	ɛʃpɛɾɐʃ	ESpEraS	o
imediato	imɛdiɐto	imEdiato	o
descoberta	dɛʃkobɛɾtɐ	dESkobErta	o
desligue	dɛʃliɡʷɛ	dESligw~E	o
conduz	konduʒ	konduZ	o
placa	plɐkɐ	plaka	o
chegarem	kɛɡɐɾɛ̃	kEgarE*	o
muro	muɾo	muro	o
cancelar	kɐnsɛlɐɾ	kansElar	o
piadas	piɐdɐʃ	piadaS	o
conde	kondɛ	kondE	o
enterrado	ɛntɛʁɐdo	EntEXado	o
trevas	tɾɛvɐʃ	trEvaS	o
lana	lɐnɐ	lana	o
contratou	kontɾɐtowu	kontratowu	o
negar	nɛɡɐɾ	nEgar	o
orelhas	oɾɛlɐʃ	orElaS	o
sentados	sɛntɐdoʃ	sEntadoS	o
julgas	ʒulɡɐʃ	ZulgaS	o
tapete	tɐpɛtɛ	tapEtE	o
comunicações	komunikɐsʃ	komunikasS	o
cultura	kultuɾɐ	kultura	o
luxo	lukso	lukso	o
conversas	konvɛɾsɐʃ	konvErsaS	o
tiverem	tivɛɾɛ̃	tivErE*	o
ronnie	ʁonniɛ	XonniE	o
mísseis	miʃsɛjʃ	miSsEyS	o
empresas	ɛmpɾɛzɐʃ	EmprEzaS	o
gritos	ɡɾitoʃ	gritoS	o
palerma	pɐlɛɾmɐ	palErma	o
entramos	ɛntɾɐmoʃ	EntramoS	o
desculpar	dɛʃkulpɐɾ	dESkulpar	o
revolução	ʁɛvolusɐ̃w̃	XEvolusa*w*	o
habilidade	ɐbilidɐdɛ	abilidadE	o
japoneses	ʒɐponɛzɛʃ	ZaponEzES	o
apertar	ɐpɛɾtɐɾ	apErtar	o
suspeita	suʃpɛjtɐ	suSpEyta	o
possíveis	poʃsivɛjʃ	poSsivEyS	o
joseph	ʒozɛp	ZozEp	n
mira	miɾɐ	mira	o
adolescente	ɐdolɛʃsɛntɛ	adolESsEntE	o
tarado	tɐɾɐdo	tarado	o
dale	dɐlɛ	dalE	n
colégio	koleʒio	koleZio	o
absoluta	ɐbsolutɐ	absoluta	o
servem	sɛɾvɛ̃	sErvE*	o
altos	ɐltoʃ	altoS	n
honestamente	onɛʃtɐmɛntɛ	onEStamEntE	o
envia	ɛnviɐ	Envia	o
puseste	puzɛʃtɛ	puzEStE	o
oxigénio	oksiʒenio	oksiZenio	o
lembram	lɛmbɾɐ̃	lEmbra*	o
marie	mɐɾiɛ	mariE	o
confissão	konfiʃsɐ̃w̃	konfiSsa*w*	o
asneira	ɐʃnɛjɾɐ	aSnEyra	o
liz	liʒ	liZ	o
cavaleiros	kɐvɐlɛjɾoʃ	kavalEyroS	o
adulto	ɐdulto	adulto	o
movimentos	movimɛntoʃ	movimEntoS	o
radiação	ʁɐdiɐsɐ̃w̃	Xadiasa*w*	o
publicidade	publizidɐdɛ	publizidadE	o
tais	tajʃ	tayS	n
decidimos	dɛzidimoʃ	dEzidimoS	o
aterrar	ɐtɛʁɐɾ	atEXar	o
quentes	kʷɛntɛʃ	kw~EntES	o
medidas	mɛdidɐʃ	mEdidaS	o
gostaste	ɡoʃtɐʃtɛ	goStaStE	o
letras	lɛtʁɐʃ	lEtXaS	o
passaporte	pɐʃsɐpoɾtɛ	paSsaportE	o
refiro	ʁɛfiɾo	XEfiro	o
feridas	fɛɾidɐʃ	fEridaS	o
bebo	bɛbo	bEbo	o
vamo	vɐmo	vamo	o
global	ɡlobɐl	global	s
caixão	kajksɐ̃w̃	kayksa*w*	o
preocupem	pɾɛokupɛ̃	prEokupE*	o
restos	ʁɛʃtoʃ	XEStoS	o
anthony	ɐntonj	antony	n
únicos	unikoʃ	unikoS	o
dona	donɐ	dona	n
es	ɛʃ	ES	n
briga	bɾiɡɐ	briga	o
inconsciente	inkonsiɛntɛ	inkonsiEntE	o
vendeu	vɛndew	vEndew	o
cometeu	komɛtew	komEtew	o
aéreo	ɐeɾɛo	aerEo	o
influência	influensiɐ	influensia	o
stephen	stɛpɛ̃	stEpE*	n
guerreiros	ɡʷɛʁɛjɾoʃ	gw~EXEyroS	o
feiticeiro	fɛjtizɛjɾo	fEytizEyro	o
havendo	ɐvɛndo	avEndo	o
convencido	konvɛnsido	konvEnsido	o
ultrapassar	ultɾɐpɐʃsɐɾ	ultrapaSsar	o
russell	ʁuʃsɛll	XuSsEll	n
shane	sɐnɛ	sanE	o
jessica	ʒɛʃsikɐ	ZESsika	o
daisy	dajzj	dayzy	n
dúzia	duziɐ	duzia	o
segurem	sɛɡʁɛ̃	sEgXE*	o
admira	ɐdmiɾɐ	admira	o
virou	viɾowu	virowu	o
calem	kɐlɛ̃	kalE*	o
conselhos	konsɛloʃ	konsEloS	o
função	funsɐ̃w̃	funsa*w*	o
todd	todd	todd	n
conhecida	konɛzidɐ	konEzida	o
ficheiro	fikɛjɾo	fikEyro	o
digital	diʒitɐl	diZital	a
piorar	pioɾɐɾ	piorar	o
capítulo	kɐpitulo	kapitulo	o
descoberto	dɛʃkobɛɾto	dESkobErto	o
profissionais	pɾofiʃsionajʃ	profiSsionayS	o
indica	indikɐ	indika	o
meios	mɛjoʃ	mEyoS	o
fadas	fɐdɐʃ	fadaS	o
ana	ɐnɐ	ana	n
companheiros	kompɐnɛjɾoʃ	kompanEyroS	o
lawrence	lɐwʁɛnsɛ	lawXEnsE	n
piso	pizo	pizo	o
experimenta	ɛspɛɾimɛntɐ	EspErimEnta	o
procurei	pɾokuɾɛj	prokurEy	o
karl	kɐɾl	karl	o
decidido	dɛzidido	dEzidido	o
quietos	kʷiɛtoʃ	kw~iEtoS	o
privacidade	pɾivɐzidɐdɛ	privazidadE	o
ande	ɐndɛ	andE	o
sombras	sombɾɐʃ	sombraS	o
devêssemos	dɛveʃsɛmoʃ	dEveSsEmoS	o
prioridade	pɾioɾidɐdɛ	prioridadE	o
inventar	invɛntɐɾ	invEntar	o
população	populɐsɐ̃w̃	populasa*w*	o
saíste	saj́ʃtɛ	sayStE	o
outubro	owutubʁo	owutubXo	o
stanley	stɐnlɛj	stanlEy	n
revelar	ʁɛvɛlɐɾ	XEvElar	o
contado	kontɐdo	kontado	o
vendedor	vɛndɛdoɾ	vEndEdor	o
leitura	lɛjtuɾɐ	lEytura	o
refere	ʁɛfɛɾɛ	XEfErE	o
começando	komɛsɐndo	komEsando	o
dormindo	doɾmindo	dormindo	o
ministério	miniʃteɾio	miniSterio	o
radar	ʁɐdɐɾ	Xadar	n
nicole	nikolɛ	nikolE	o
saias	sɐjɐʃ	sayaS	o
beija	bɛjʒɐ	bEyZa	o
vier	viɛɾ	viEr	s
mereço	mɛɾɛso	mErEso	o
piedade	piɛdɐdɛ	piEdadE	o
séria	seɾiɐ	seria	o
tigre	tiɡʁɛ	tigXE	o
acreditamos	ɐkʁɛditɐmoʃ	akXEditamoS	o
deixares	dɛjksɐɾɛʃ	dEyksarES	o
harvard	ɐɾvɐɾd	arvard	n
cocaína	kokaj́nɐ	kokayna	o
megan	mɛɡɐ̃	mEga*	o
sais	sajʃ	sayS	o
posições	pozisʃ	pozisS	o
parecida	pɐɾɛzidɐ	parEzida	o
doenças	dowɛnsɐʃ	dowEnsaS	o
clay	klɐj	klay	n
noção	nosɐ̃w̃	nosa*w*	o
rumores	ʁumoɾɛʃ	XumorES	v
walt	wɐlt	walt	o
prática	pɾatikɐ	pratika	o
recorde	ʁɛkoɾdɛ	XEkordE	o
arrepender	ɐʁɛpɛndɛɾ	aXEpEndEr	o
coloquei	kolokʷɛj	kolokw~Ey	o
tonto	tonto	tonto	o
ellen	ɛllɛ̃	EllE*	o
pesada	pɛzɐdɐ	pEzada	o
frigorífico	fɾiɡoɾifiko	frigorifiko	o
tubarão	tubɐɾɐ̃w̃	tubara*w*	o
natalie	nɐtɐliɛ	nataliE	o
mochila	mokilɐ	mokila	o
collins	kollinʃ	kollinS	n
catherine	kɐtɛɾinɛ	katErinE	n
harold	ɐɾold	arold	o
criada	kɾiɐdɐ	kriada	o
cinzas	sinzɐʃ	sinzaS	o
conseguires	konsɛɡʷiɾɛʃ	konsEgw~irES	o
andaste	ɐndɐʃtɛ	andaStE	o
sobreviveu	sobʁɛvivew	sobXEvivew	o
progresso	pɾoɡʁɛʃso	progXESso	o
profissão	pɾofiʃsɐ̃w̃	profiSsa*w*	o
receita	ʁɛzɛjtɐ	XEzEyta	o
submarino	submɐɾino	submarino	o
diego	diɛɡo	diEgo	o
arco	ɐɾko	arko	s
pretende	pɾɛtɛndɛ	prEtEndE	o
dna	dnɐ	dna	n
visse	viʃsɛ	viSsE	o
cody	kodj	kody	n
namorados	nɐmoɾɐdoʃ	namoradoS	o
sue	suɛ	suE	n
willie	williɛ	williE	o
samantha	sɐmɐntɐ	samanta	o
espanha	ɛʃpɐnɐ	ESpana	o
quieta	kʷiɛtɐ	kw~iEta	o
russa	ʁuʃsɐ	XuSsa	o
torneio	toɾnɛjo	tornEyo	o
gaja	ɡɐʒɐ	gaZa	o
matando	mɐtɐndo	matando	o
avisa	ɐvizɐ	aviza	o
planeado	plɐnɛɐdo	planEado	o
eventos	ɛvɛntoʃ	EvEntoS	o
jess	ʒɛsʃ	ZEsS	o
wade	wɐdɛ	wadE	n
instalações	instɐlɐsʃ	instalasS	o
recusar	ʁɛkuzɐɾ	XEkuzar	o
enterprise	ɛntɛɾpɾizɛ	EntErprizE	n
esperanças	ɛʃpɛɾɐnsɐʃ	ESpEransaS	o
pormenores	poɾmɛnoɾɛʃ	pormEnorES	o
meredith	mɛɾɛdit	mErEdit	n
usamos	uzɐmoʃ	uzamoS	o
voltares	voltɐɾɛʃ	voltarES	o
conheceste	konɛzɛʃtɛ	konEzEStE	o
fraude	fɾawdɛ	frawdE	o
médio	medio	medio	o
informado	infoɾmɐdo	informado	o
tatuagem	tɐtuɐʒɛ̃	tatuaZE*	o
rasto	ʁɐʃto	XaSto	o
mudado	mudɐdo	mudado	o
consertar	konsɛɾtɐɾ	konsErtar	o
levará	lɛvɐɾa	lEvara	o
ingleses	inɡlɛzɛʃ	inglEzES	o
fechados	fɛkɐdoʃ	fEkadoS	o
alvos	ɐlvoʃ	alvoS	o
jeremy	ʒɛɾɛmj	ZErEmy	o
ocasião	okɐziɐ̃w̃	okazia*w*	o
velas	vɛlɐʃ	vElaS	n
peru	pɛɾu	pEru	n
voltado	voltɐdo	voltado	o
gado	ɡɐdo	gado	o
distante	diʃtɐntɛ	diStantE	o
conheça	konɛsɐ	konEsa	o
mereces	mɛɾɛzɛʃ	mErEzES	o
feitiço	fɛjtiso	fEytiso	o
grátis	ɡɾatiʃ	gratiS	o
capital	kɐpitɐl	kapital	n
lord	loɾd	lord	n
miolos	mioloʃ	mioloS	o
it	it	it	n
fãs	fɐ̃ʃ	fa*S	o
green	ɡɾɛɛ̃	grEE*	n
velhas	vɛlɐʃ	vElaS	o
seco	sɛko	sEko	o
tumor	tumoɾ	tumor	n
derrotar	dɛʁotɐɾ	dEXotar	o
viria	viɾiɐ	viria	o
kirk	kiɾk	kirk	n
wallace	wɐllɐzɛ	wallazE	n
êxito	eksito	eksito	o
pudesses	pudɛʃsɛʃ	pudESsES	o
marco	mɐɾko	marko	o
descobriram	dɛʃkobʁiɾɐ̃	dESkobXira*	o
bombeiros	bombɛjɾoʃ	bombEyroS	o
voltarmos	voltɐɾmoʃ	voltarmoS	o
acreditei	ɐkʁɛditɛj	akXEditEy	o
palmer	pɐlmɛɾ	palmEr	n
suave	suɐvɛ	suavE	s
escravo	ɛʃkɾɐvo	ESkravo	o
deixava	dɛjksɐvɐ	dEyksava	o
angel	ɐnʒɛl	anZEl	n
taça	tɐsɐ	tasa	o
suba	subɐ	suba	o
pedindo	pɛdindo	pEdindo	o
by	bj	by	r
selvagens	sɛlvɐʒɛnʃ	sElvaZEnS	o
Holly	ollj	olly	n
acontecesse	ɐkontɛzɛʃsɛ	akontEzESsE	o
amanhecer	ɐmɐnɛzɛɾ	amanEzEr	o
Mitch	mitk	mitk	o
péssima	peʃsimɐ	peSsima	o
viesse	viɛʃsɛ	viESsE	o
reis	ʁɛjʃ	XEyS	n
von	võ	vo*	o
Anderson	ɐndɛɾsõ	andErso*	n
cheios	kɛjoʃ	kEyoS	o
miserável	mizɛɾavɛl	mizEravEl	o
emoção	ɛmosɐ̃w̃	Emosa*w*	o
little	littlɛ	littlE	n
rocha	ʁokɐ	Xoka	o
parvalhão	pɐɾvɐlɐ̃w̃	parvala*w*	o
raro	ʁɐɾo	Xaro	o
verdadeiramente	vɛɾdɐdɛjɾɐmɛntɛ	vErdadEyramEntE	o
Jamie	ʒɐmiɛ	ZamiE	o
político	politiko	politiko	o
ganhaste	ɡɐnɐʃtɛ	ganaStE	o
Marge	mɐɾʒɛ	marZE	n
bens	bɛnʃ	bEnS	n
bandidos	bɐndidoʃ	bandidoS	o
nuvens	nuvɛnʃ	nuvEnS	o
Simpson	simpsõ	simpso*	n
Evan	ɛvɐ̃	Eva*	o
complexo	komplɛkso	komplEkso	o
desenhos	dɛzɛnoʃ	dEzEnoS	o
assassínio	ɐʃsɐʃsinio	aSsaSsinio	o
Katherine	kɐtɛɾinɛ	katErinE	o
drama	dɾɐmɐ	drama	n
recordar	ʁɛkoɾdɐɾ	XEkordar	o
ficarem	fikɐɾɛ̃	fikarE*	o
junho	ʒuno	Zuno	o
stark	stɐɾk	stark	s
destruiu	dɛʃtɾuju	dEStruyu	o
falaram	fɐlɐɾɐ̃	falara*	o
proibido	pɾowibido	prowibido	o
pastor	pɐʃtoɾ	paStor	n
pontapé	pontɐpe	pontape	o
nicky	nikkj	nikky	o
lentamente	lɛntɐmɛntɛ	lEntamEntE	o
kramer	kɾɐmɛɾ	kramEr	o
novidade	novidɐdɛ	novidadE	o
analisar	ɐnɐlizɐɾ	analizar	o
atmosfera	ɐtmoʃfɛɾɐ	atmoSfEra	o
esclarecer	ɛʃklɐɾɛzɛɾ	ESklarEzEr	o
tarte	tɐɾtɛ	tartE	o
estais	ɛʃtajʃ	EStayS	o
demónios	dɛmɔnioʃ	dEmonioS	o
estrangeiro	ɛʃtɾɐnʒɛjɾo	EStranZEyro	o
trate	tɾɐtɛ	tratE	o
vaga	vɐɡɐ	vaga	o
pareça	pɐɾɛsɐ	parEsa	o
produtos	pɾodutoʃ	produtoS	o
elegante	ɛlɛɡɐntɛ	ElEgantE	o
mason	mɐzõ	mazo*	n
inveja	invɛʒɐ	invEZa	o
líderes	lidɛɾɛʃ	lidErES	o
basebol	bɐzɛbol	bazEbol	o
crânio	kɾanio	kranio	o
ala	ɐlɐ	ala	n
reed	ʁɛɛd	XEEd	n
aceitou	ɐzɛjtowu	azEytowu	o
sensores	sɛnsoɾɛʃ	sEnsorES	o
galáxia	ɡɐlaksiɐ	galaksia	o
imagine	imɐʒinɛ	imaZinE	v
poupar	powupɐɾ	powupar	o
eliminar	ɛliminɐɾ	Eliminar	o
firma	fiɾmɐ	firma	o
turner	tuɾnɛɾ	turnEr	n
extraordinário	ɛstɾɐoɾdinaɾio	Estraordinario	o
cresceu	kɾɛʃsew	krESsew	o
leves	lɛvɛʃ	lEvES	o
interna	intɛɾnɐ	intErna	o
invisível	invizivɛl	invizivEl	o
refém	ʁɛfẽ	XEfe*	o
ford	foɾd	ford	n
juramento	ʒuɾɐmɛnto	ZuramEnto	o
provocar	pɾovokɐɾ	provokar	o
horríveis	oʁivɛjʃ	oXivEyS	o
cometi	komɛti	komEti	o
albert	ɐlbɛɾt	albErt	n
comecem	komɛzɛ̃	komEzE*	o
levando	lɛvɐndo	lEvando	o
iriam	iɾiɐ̃	iria*	o
deverá	dɛvɛɾa	dEvEra	o
cadê	kɐde	kade	o
grey	ɡɾɛj	grEy	n
importava	impoɾtɐvɐ	importava	o
duque	dukʷɛ	dukw~E	o
vic	vik	vik	o
levamos	lɛvɐmoʃ	lEvamoS	o
diretor	diɾɛtoɾ	dirEtor	o
entro	ɛntɾo	Entro	o
pediram	pɛdiɾɐ̃	pEdira*	o
sandy	sɐndj	sandy	s
fox	fos	fos	n
abertura	ɐbɛɾtuɾɐ	abErtura	o
suportar	supoɾtɐɾ	suportar	o
wendy	wɛndj	wEndy	o
correndo	koʁɛndo	koXEndo	o
cabelos	kɐbɛloʃ	kabEloS	o
bagagem	bɐɡɐʒɛ̃	bagaZE*	o
voltaremos	voltɐɾɛmoʃ	voltarEmoS	o
procuram	pɾokuɾɐ̃	prokura*	o
armar	ɐɾmɐɾ	armar	o
bruxas	bɾuksɐʃ	bruksaS	o
lenny	lɛnnj	lEnny	o
condução	kondusɐ̃w̃	kondusa*w*	o
deitado	dɛjtɐdo	dEytado	o
surpreendido	suɾpɾɛɛndido	surprEEndido	o
raymond	ʁɐjmond	Xaymond	o
concordar	konkoɾdɐɾ	konkordar	o
stress	stɾɛsʃ	strEsS	n
encontros	ɛnkontɾoʃ	EnkontroS	o
audição	awdisɐ̃w̃	awdisa*w*	o
despachem	dɛʃpɐkɛ̃	dESpakE*	o
escala	ɛʃkɐlɐ	ESkala	o
conspiração	konspiɾɐsɐ̃w̃	konspirasa*w*	o
fontes	fontɛʃ	fontES	o
famosa	fɐmozɐ	famoza	o
cadela	kɐdɛlɐ	kadEla	o
prestar	pɾɛʃtɐɾ	prEStar	o
terminei	tɛɾminɛj	tErminEy	o
pelotão	pɛlotɐ̃w̃	pElota*w*	o
congresso	konɡɾɛʃso	kongrESso	o
fodido	fodido	fodido	o
torres	toʁɛʃ	toXES	o
tess	tɛsʃ	tEsS	n
antigas	ɐntiɡɐʃ	antigaS	o
matthew	mɐttɛw	mattEw	n
tortura	toɾtuɾɐ	tortura	o
colecção	kolɛksɐ̃w̃	kolEksa*w*	o
dificuldade	difikuldɐdɛ	difikuldadE	o
keith	kɛjt	kEyt	o
deixaria	dɛjksɐɾiɐ	dEyksaria	o
metas	mɛtɐʃ	mEtaS	o
chineses	kinɛzɛʃ	kinEzES	n
armados	ɐɾmɐdoʃ	armadoS	o
tás	taʃ	taS	o
considerado	konsidɛɾɐdo	konsidErado	o
dormiu	doɾmiw	dormiw	o
solitário	solitaɾio	solitario	o
aquecer	ɐkʷɛzɛɾ	akw~EzEr	o
sonny	sonnj	sonny	n
hemorragia	ɛmoʁɐʒiɐ	EmoXaZia	o
precise	pɾɛzisɛ	prEzisE	a
acordou	ɐkoɾdowu	akordowu	o
caminhos	kɐminoʃ	kaminoS	o
marcha	mɐɾkɐ	marka	o
ficasse	fikɐʃsɛ	fikaSsE	o
williams	williɐmʃ	williamS	n
interesses	intɛɾɛʃsɛʃ	intErESsES	v
recebo	ʁɛzɛbo	XEzEbo	o
bailey	bajlɛj	baylEy	n
manny	mɐnnj	manny	o
bêbedo	bebɛdo	bebEdo	o
espingarda	ɛʃpinɡɐɾdɐ	ESpingarda	o
organizar	oɾɡɐnizɐɾ	organizar	o
ficaremos	fikɐɾɛmoʃ	fikarEmoS	o
reconhece	ʁɛkonɛzɛ	XEkonEzE	o
estarás	ɛʃtɐɾaʃ	EStaraS	o
canadá	kɐnɐda	kanada	o
magnífico	mɐɡnifiko	magnifiko	o
enfiar	ɛnfiɐɾ	Enfiar	o
aprende	ɐpʁɛndɛ	apXEndE	o
delta	dɛltɐ	dElta	n
objecto	obʒɛkto	obZEkto	o
fazermos	fɐzɛɾmoʃ	fazErmoS	o
pretos	pɾɛtoʃ	prEtoS	o
salvei	sɐlvɛj	salvEy	o
pratos	pɾɐtoʃ	pratoS	o
my	mj	my	o
trevor	tɾɛvoɾ	trEvor	o
federais	fɛdɛɾajʃ	fEdErayS	o
houston	owuʃtõ	owuSto*	n
queiram	kʷɛjɾɐ̃	kw~Eyra*	o
enormes	ɛnoɾmɛʃ	EnormES	o
estratégia	ɛʃtɾɐteʒiɐ	EStrateZia	o
suja	suʒɐ	suZa	o
pescar	pɛʃkɐɾ	pESkar	o
considera	konsidɛɾɐ	konsidEra	o
sector	sɛktoɾ	sEktor	n
aluno	ɐluno	aluno	o
admito	ɐdmito	admito	o
ginásio	ʒinazio	Zinazio	o
escolas	ɛʃkolɐʃ	ESkolaS	o
comissário	komiʃsaɾio	komiSsario	o
protocolo	pɾotokolo	protokolo	o
rob	ʁob	Xob	v
fada	fɐdɐ	fada	o
cidadão	sidɐdɐ̃w̃	sidada*w*	o
encomenda	ɛnkomɛndɐ	EnkomEnda	o
naquilo	nɐkʷilo	nakw~ilo	o
cirurgião	siɾuɾʒiɐ̃w̃	sirurZia*w*	o
usada	uzɐdɐ	uzada	o
gina	ʒinɐ	Zina	o
odiar	odiɐɾ	odiar	o
reverendo	ʁɛvɛɾɛndo	XEvErEndo	o
fabuloso	fɐbulozo	fabulozo	o
acertou	ɐzɛɾtowu	azErtowu	o
ofensa	ofɛnsɐ	ofEnsa	o
cowboy	kowbowj	kowbowy	n
cervejas	sɛɾvɛʒɐʃ	sErvEZaS	o
química	kʷimikɐ	kw~imika	o
hong	onɡ	ong	o
artes	ɐɾtɛʃ	artES	o
abril	ɐbʁil	abXil	o
infantil	infɐntil	infantil	o
fruta	fɾutɐ	fruta	o
eternidade	ɛtɛɾnidɐdɛ	EtErnidadE	o
prometer	pɾomɛtɛɾ	promEtEr	o
palpite	pɐlpitɛ	palpitE	o
conseguiria	konsɛɡʷiɾiɐ	konsEgw~iria	o
dana	dɐnɐ	dana	n
beba	bɛbɐ	bEba	o
pesadelos	pɛzɐdɛloʃ	pEzadEloS	o
atirem	ɐtiɾɛ̃	atirE*	o
instinto	instinto	instinto	o
preocupo	pɾɛokupo	prEokupo	o
moto	moto	moto	o
procure	pɾokuɾɛ	prokurE	v
pintura	pintuɾɐ	pintura	o
duke	dukɛ	dukE	n
tristeza	tɾiʃtɛzɐ	triStEza	o
nessas	nɛʃsɐʃ	nESsaS	o
horror	oʁoɾ	oXor	n
armada	ɐɾmɐdɐ	armada	n
viveu	vivew	vivew	o
kenny	kɛnnj	kEnny	o
entram	ɛntɾɐ̃	Entra*	o
onze	onzɛ	onzE	o
lógica	lɔʒikɐ	loZika	o
familiares	fɐmiliɐɾɛʃ	familiarES	o
tiraste	tiɾɐʃtɛ	tiraStE	o
cameron	kɐmɛɾõ	kamEro*	o
puderes	pudɛɾɛʃ	pudErES	o
seguido	sɛɡʷido	sEgw~ido	o
ann	ɐn	an	o
lindos	lindoʃ	lindoS	o
realizar	ʁɛɐlizɐɾ	XEalizar	o
cuidados	kujdɐdoʃ	kuydadoS	o
acordada	ɐkoɾdɐdɐ	akordada	o
permanecer	pɛɾmɐnɛzɛɾ	pErmanEzEr	o
vestidos	vɛʃtidoʃ	vEStidoS	o
órgãos	ɔɾɡɐ̃w̃ʃ	orga*w*S	o
divertida	divɛɾtidɐ	divErtida	o
fraca	fɾɐkɐ	fraka	o
harris	ɐʁiʃ	aXiS	n
franco	fɾɐnko	franko	n
ho	o	o	n
sequência	sɛkʷensiɐ	sEkw~ensia	o
bife	bifɛ	bifE	o
electricidade	ɛlɛktɾizidɐdɛ	ElEktrizidadE	o
blue	bluɛ	bluE	n
verifica	vɛɾifikɐ	vErifika	o
orelha	oɾɛlɐ	orEla	o
marte	mɐɾtɛ	martE	o
profundamente	pɾofundɐmɛntɛ	profundamEntE	o
co	ko	ko	n
dissemos	diʃsɛmoʃ	diSsEmoS	o
traiu	tɾɐju	trayu	o
perfume	pɛɾfumɛ	pErfumE	n
cabine	kɐbinɛ	kabinE	o
rebeldes	ʁɛbɛldɛʃ	XEbEldES	o
francesa	fɾɐnsɛzɐ	fransEza	o
folhas	folɐʃ	folaS	o
ficarão	fikɐɾɐ̃w̃	fikara*w*	o
concentra	konsɛntɾɐ	konsEntra	o
trabalhadores	tɾɐbɐlɐdoɾɛʃ	trabaladorES	o
finais	finajʃ	finayS	o
pedro	pɛdʁo	pEdXo	o
estivessem	ɛʃtivɛʃsɛ̃	EStivESsE*	o
disposição	diʃpozisɐ̃w̃	diSpozisa*w*	o
apresenta	ɐpʁɛzɛntɐ	apXEzEnta	o
Holmes	olmɛʃ	olmES	n
abaixe	ɐbajksɛ	abayksE	o
andares	ɐndɐɾɛʃ	andarES	o
lane	lɐnɛ	lanE	n
embaixada	ɛmbajksɐdɐ	Embayksada	o
bingo	binɡo	bingo	n
obrigar	obʁiɡɐɾ	obXigar	o
processar	pɾozɛʃsɐɾ	prozESsar	o
Tina	tinɐ	tina	o
maya	mɐjɐ	maya	n
julga	ʒulɡɐ	Zulga	o
alfa	ɐlfɐ	alfa	o
cópias	kɔpiɐʃ	kopiaS	o
seguiu	sɛɡʷiw	sEgw~iw	o
atingiu	ɐtinʒiw	atinZiw	o
razoável	ʁɐzowavɛl	XazowavEl	o
escuto	ɛʃkuto	ESkuto	o
julgo	ʒulɡo	Zulgo	o
resulta	ʁɛzultɐ	XEzulta	o
abandonou	ɐbɐndonowu	abandonowu	o
florida	floɾidɐ	florida	n
pesca	pɛʃkɐ	pESka	o
túmulo	tumulo	tumulo	o
cujo	kuʒo	kuZo	o
caverna	kɐvɛɾnɐ	kavErna	o
sabedoria	sɐbɛdoɾiɐ	sabEdoria	o
fiel	fiɛl	fiEl	o
discos	diʃkoʃ	diSkoS	n
times	timɛʃ	timES	n
chegará	kɛɡɐɾa	kEgara	o
reuniões	ʁewniʃ	XewniS	o
abandonado	ɐbɐndonɐdo	abandonado	o
roubaste	ʁowubɐʃtɛ	XowubaStE	o
esperemos	ɛʃpɛɾɛmoʃ	ESpErEmoS	o
fraqueza	fɾɐkʷɛzɐ	frakw~Eza	o
cria	kɾiɐ	kria	o
taco	tɐko	tako	n
baixas	bajksɐʃ	bayksaS	o
marley	mɐɾlɛj	marlEy	n
cêntimos	sentimoʃ	sentimoS	o
descobriste	dɛʃkobʁiʃtɛ	dESkobXiStE	o
procurador	pɾokuɾɐdoɾ	prokurador	o
queridos	kʷɛɾidoʃ	kw~EridoS	o
bastardo	bɐʃtɐɾdo	baStardo	o
bunda	bundɐ	bunda	o
monsieur	monsiewɾ	monsiewr	n
arroz	ɐʁoʒ	aXoZ	o
site	sitɛ	sitE	n
absurdo	ɐbsuɾdo	absurdo	o
trono	tɾono	trono	o
sonhei	sonɛj	sonEy	o
itália	italiɐ	italia	o
troy	tɾowj	trowy	n
medalha	mɛdɐlɐ	mEdala	o
habilidades	ɐbilidɐdɛʃ	abilidadES	o
tiras	tiɾɐʃ	tiraS	o
durmo	duɾmo	durmo	o
exceto	ɛsɛto	EsEto	o
brinquedo	bɾinkʷɛdo	brinkw~Edo	o
intenções	intɛnsʃ	intEnsS	o
chego	kɛɡo	kEgo	o
lido	lido	lido	n
merecem	mɛɾɛzɛ̃	mErEzE*	o
desperdiçar	dɛʃpɛɾdisɐɾ	dESpErdisar	o
pós	pɔʃ	poS	o
separados	sɛpɐɾɐdoʃ	sEparadoS	o
merlin	mɛɾlĩ	mErli*	n
chamaram	kɐmɐɾɐ̃	kamara*	o
vc	vk	vk	o
tentaste	tɛntɐʃtɛ	tEntaStE	o
políticos	politikoʃ	politikoS	o
divirtam	diviɾtɐ̃	divirta*	o
sobremesa	sobʁɛmɛzɐ	sobXEmEza	o
levava	lɛvɐvɐ	lEvava	o
criação	kɾiɐsɐ̃w̃	kriasa*w*	o
execução	ɛzɛkusɐ̃w̃	EzEkusa*w*	o
haviam	ɐviɐ̃	avia*	o
índios	indioʃ	indioS	o
grau	ɡɾaw	graw	o
ônibus	onibuʃ	onibuS	o
necessidades	nɛzɛʃsidɐdɛʃ	nEzESsidadES	o
mistura	miʃtuɾɐ	miStura	o
pilotos	pilotoʃ	pilotoS	o
economia	ɛkonomiɐ	Ekonomia	o
cagar	kɐɡɐɾ	kagar	o
perdê	pɛɾde	pErde	o
procuras	pɾokuɾɐʃ	prokuraS	o
voltam	voltɐ̃	volta*	o
traduzido	tɾɐduzido	traduzido	o
indústria	induʃtɾiɐ	induStria	o
preocupados	pɾɛokupɐdoʃ	prEokupadoS	o
familia	fɐmiliɐ	familia	o
técnico	tekniko	tekniko	o
prometeste	pɾomɛtɛʃtɛ	promEtEStE	o
sugere	suʒɛɾɛ	suZErE	o
recordo	ʁɛkoɾdo	XEkordo	o
bonitos	bonitoʃ	bonitoS	n
disparo	diʃpɐɾo	diSparo	o
sensual	sɛnsuɐl	sEnsual	s
rever	ʁɛvɛɾ	XEvEr	o
padrinho	pɐdʁino	padXino	o
rebecca	ʁɛbɛkkɐ	XEbEkka	n
andem	ɐndɛ̃	andE*	o
cordas	koɾdɐʃ	kordaS	o
máfia	mafiɐ	mafia	o
esquema	ɛʃkʷɛmɐ	ESkw~Ema	o
cadáveres	kɐdavɛɾɛʃ	kadavErES	o
lojas	loʒɐʃ	loZaS	o
biscoitos	biʃkowitoʃ	biSkowitoS	o
possibilidades	poʃsibilidɐdɛʃ	poSsibilidadES	o
cal	kɐl	kal	o
freddy	fɾɛddj	frEddy	o
físico	fiziko	fiziko	o
quebra	kʷɛbʁɐ	kw~EbXa	o
preta	pɾɛtɐ	prEta	o
voa	vowɐ	vowa	o
consulta	konsultɐ	konsulta	o
yo	jo	yo	o
vanessa	vɐnɛʃsɐ	vanESsa	n
travis	tɾɐviʃ	traviS	o
examinar	ɛzɐminɐɾ	Ezaminar	o
dupla	duplɐ	dupla	o
malucos	mɐlukoʃ	malukoS	o
desgraça	dɛʃɡɾɐsɐ	dESgrasa	o
arranje	ɐʁɐnʒɛ	aXanZE	o
elena	ɛlɛnɐ	ElEna	o
confidencial	konfidɛnsiɐl	konfidEnsial	o
oscar	oʃkɐɾ	oSkar	n
meteste	mɛtɛʃtɛ	mEtEStE	o
curtis	kuɾtiʃ	kurtiS	n
eventualmente	ɛvɛntuɐlmɛntɛ	EvEntualmEntE	o
stu	stu	stu	o
cinquenta	sinkʷɛntɐ	sinkw~Enta	o
algemas	ɐlʒɛmɐʃ	alZEmaS	o
escolhas	ɛʃkolɐʃ	ESkolaS	o
sebastian	sɛbɐʃtiɐ̃	sEbaStia*	o
perdendo	pɛɾdɛndo	pErdEndo	o
impressionado	impɾɛʃsionɐdo	imprESsionado	o
chinesa	kinɛzɐ	kinEza	o
salve	sɐlvɛ	salvE	n
recuar	ʁɛkuɐɾ	XEkuar	o
nesses	nɛʃsɛʃ	nESsES	n
rosas	ʁozɐʃ	XozaS	n
novembro	novɛmbɾo	novEmbro	o
ihes	iɛʃ	iES	o
navios	nɐvioʃ	navioS	o
trair	tɾajɾ	trayr	o
chamaste	kɐmɐʃtɛ	kamaStE	o
olhadela	olɐdɛlɐ	oladEla	o
amado	ɐmɐdo	amado	o
cachorros	kɐkoʁoʃ	kakoXoS	o
mude	mudɛ	mudE	o
quiseste	kʷizɛʃtɛ	kw~izEStE	o
barbara	bɐɾbɐɾɐ	barbara	o
impedi	impɛdi	impEdi	o
pegamos	pɛɡɐmoʃ	pEgamoS	o
caleb	kɐlɛb	kalEb	o
zoe	zowɛ	zowE	o
alguem	ɐlɡʷɛ̃	algw~E*	o
escudos	ɛʃkudoʃ	ESkudoS	n
transformou	tɾɐnsfoɾmowu	transformowu	o
pacífico	pɐzifiko	pazifiko	o
namorar	nɐmoɾɐɾ	namorar	o
capacidades	kɐpɐzidɐdɛʃ	kapazidadES	o
salvaste	sɐlvɐʃtɛ	salvaStE	o
quartel	kɐɾtɛl	kartEl	o
explorar	ɛsploɾɐɾ	Esplorar	o
arruinar	ɐʁujnɐɾ	aXuynar	o
percebem	pɛɾsɛbɛ̃	pErsEbE*	o
permitido	pɛɾmitido	pErmitido	o
estradas	ɛʃtɾɐdɐʃ	EStradaS	o
tornado	toɾnɐdo	tornado	n
revistas	ʁɛviʃtɐʃ	XEviStaS	o
francis	fɾɐnsiʃ	fransiS	o
cresci	kɾɛʃsi	krESsi	o
fizermos	fizɛɾmoʃ	fizErmoS	o
bata	bɐtɐ	bata	n
descrição	dɛʃkɾisɐ̃w̃	dESkrisa*w*	o
amei	ɐmɛj	amEy	o
castle	kɐʃtlɛ	kaStlE	n
